TAG	TEXT	COMMENT	AUDIOFILE
GAMEPLAY_EMOTE_EX1_323h_CONCEDE	Я проиграл... НО ТВОЙ МИР ВСЕ РАВНО ОБРЕЧЕН!!!		
GAMEPLAY_EMOTE_EX1_323h_ERROR_FULL_MINIONS	СЛИШКОМ МНОГО СУЩЕСТВ!!!		
GAMEPLAY_EMOTE_EX1_323h_ERROR_GENERIC	НЕ МОГУ ЭТО СДЕЛАТЬ!		
GAMEPLAY_EMOTE_EX1_323h_ERROR_HAND_FULL	СЛИШКОМ МНОГО КАРТ!!!		
GAMEPLAY_EMOTE_EX1_323h_ERROR_I_ATTACKED	Я УЖЕ АТАКОВАЛ!		
GAMEPLAY_EMOTE_EX1_323h_ERROR_JUST_PLAYED	Я ТОЛЬКО ЧТО ВЫЗВАЛ ЭТО СУЩЕСТВО!		
GAMEPLAY_EMOTE_EX1_323h_ERROR_MINION_ATTACKED	ЭТО СУЩЕСТВО УЖЕ АТАКОВАЛО!		
GAMEPLAY_EMOTE_EX1_323h_ERROR_NEED_MANA	НЕДОСТАТОЧНО МАНЫ!		
GAMEPLAY_EMOTE_EX1_323h_ERROR_NEED_WEAPON	ГДЕ МОЕ ОРУЖИЕ?		
GAMEPLAY_EMOTE_EX1_323h_ERROR_PLAY	НЕ МОГУ СЫГРАТЬ ЭТУ КАРТУ!		
GAMEPLAY_EMOTE_EX1_323h_ERROR_STEALTH	ОНО СКРЫТО!		
GAMEPLAY_EMOTE_EX1_323h_ERROR_TARGET	НЕПРАВИЛЬНАЯ ЦЕЛЬ!		
GAMEPLAY_EMOTE_EX1_323h_ERROR_TAUNT	ЭТОТ ПРОВОКАТОР СТОИТ У МЕНЯ НА ПУТИ!		
GAMEPLAY_EMOTE_EX1_323h_GOOD_GAME	ОТЛИЧНАЯ ИГРА!		
GAMEPLAY_EMOTE_EX1_323h_GREETINGS	Перед тобой Джараксус, эредарский повелитель Пылающего Легиона!		
GAMEPLAY_EMOTE_EX1_323h_LOW_CARDS	В моей колоде КОНЧАЮТСЯ КАРТЫ!		
GAMEPLAY_EMOTE_EX1_323h_LUNAR_NEW_YEAR	Saudações.		
GAMEPLAY_EMOTE_EX1_323h_NO_CARDS	НЕЕЕЕЕТ! У МЕНЯ КОНЧИЛИСЬ КАРТЫ!		
GAMEPLAY_EMOTE_EX1_323h_OOPS	ОШИБКА!!!		
GAMEPLAY_EMOTE_EX1_323h_SORRY	ДЖАРАКСУС... извиняется.		
GAMEPLAY_EMOTE_EX1_323h_THANKS	СПАСИБО.		
GAMEPLAY_EMOTE_EX1_323h_THINK1	Хм...		
GAMEPLAY_EMOTE_EX1_323h_THINK2	Интересно...		
GAMEPLAY_EMOTE_EX1_323h_THINK3	Как же мне уничтожить тебя...		
GAMEPLAY_EMOTE_EX1_323h_THREATEN	ЗАБВЕНИЕ!!!		
GAMEPLAY_EMOTE_EX1_323h_TIMER	ВРЕМЯ НА ИСХОДЕ.		
GAMEPLAY_EMOTE_EX1_323h_WELL_PLAYED	НЕПЛОХО СЫГРАНО!		
GAMEPLAY_EMOTE_EX1_323h_WINTERVEIL_GREETINGS	В этот Зимний Покров я пожру твою душу!		
GAMEPLAY_EMOTE_EX1_323h_WOW_04	НЕВЕРОЯТНО!		
GAMEPLAY_EMOTE_HERO_01_CONCEDE	Я выбираю смерть!		
GAMEPLAY_EMOTE_HERO_01_ERROR_FULL_MINIONS	У меня слишком много существ.		
GAMEPLAY_EMOTE_HERO_01_ERROR_GENERIC	Я не могу это сделать.		
GAMEPLAY_EMOTE_HERO_01_ERROR_HAND_FULL	В моей руке слишком много карт!		
GAMEPLAY_EMOTE_HERO_01_ERROR_I_ATTACKED	Я уже атаковал.		
GAMEPLAY_EMOTE_HERO_01_ERROR_JUST_PLAYED	Это существо сможет атаковать в мой следующий ход.		
GAMEPLAY_EMOTE_HERO_01_ERROR_MINION_ATTACKED	Это существо уже атаковало на этом ходу.		
GAMEPLAY_EMOTE_HERO_01_ERROR_NEED_MANA	Мне не хватает маны.		
GAMEPLAY_EMOTE_HERO_01_ERROR_NEED_WEAPON	Мне нужно оружие.		
GAMEPLAY_EMOTE_HERO_01_ERROR_PLAY	Я не могу сыграть эту карту.		
GAMEPLAY_EMOTE_HERO_01_ERROR_STEALTH	Я не могу выбрать целью замаскированное существо.		
GAMEPLAY_EMOTE_HERO_01_ERROR_TARGET	Нельзя применить к этой цели.		
GAMEPLAY_EMOTE_HERO_01_ERROR_TAUNT	Я должен атаковать провокатора.		
GAMEPLAY_EMOTE_HERO_01_EVENT_LUNAR_NEW_YEAR	Ну, здравствуй.		
GAMEPLAY_EMOTE_HERO_01_GOOD_GAME	Хорошая игра!		
GAMEPLAY_EMOTE_HERO_01_GREETINGS	Ну, здравствуй.		
GAMEPLAY_EMOTE_HERO_01_LOW_CARDS	У меня скоро кончатся карты!		
GAMEPLAY_EMOTE_HERO_01_MIRROR_START	Я выбираю победу.		
GAMEPLAY_EMOTE_HERO_01_NO_CARDS	У меня кончились карты!		
GAMEPLAY_EMOTE_HERO_01_OOPS	Это была ошибка.		
GAMEPLAY_EMOTE_HERO_01_SORRY	Прости, что так получилось.		
GAMEPLAY_EMOTE_HERO_01_START	Победа или смерть!		
GAMEPLAY_EMOTE_HERO_01_THANKS	Я тебе благодарен.		
GAMEPLAY_EMOTE_HERO_01_THINK1	Хм...		
GAMEPLAY_EMOTE_HERO_01_THINK2	Хм... Может...		
GAMEPLAY_EMOTE_HERO_01_THINK3	Что же теперь...		
GAMEPLAY_EMOTE_HERO_01_THREATEN	Я СОКРУШУ ТЕБЯ!		
GAMEPLAY_EMOTE_HERO_01_TIMER	Я ДОЛЖЕН СДЕЛАТЬ ВЫБОР!		
GAMEPLAY_EMOTE_HERO_01_WELL_PLAYED	Неплохо сыграно.		
GAMEPLAY_EMOTE_HERO_01_WINTERVEIL_GREETINGS	Счастливого праздника Зимнего Покрова!		
GAMEPLAY_EMOTE_HERO_01_WOW	Потрясающе!		
GAMEPLAY_EMOTE_HERO_01A_CONCEDE	Эх, я проиграл.		
GAMEPLAY_EMOTE_HERO_01A_ERROR_FULL_MINIONS	У меня слишком много существ.		
GAMEPLAY_EMOTE_HERO_01A_ERROR_GENERIC	Я не могу это сделать.		
GAMEPLAY_EMOTE_HERO_01A_ERROR_HAND_FULL	В моей руке слишком много карт!		
GAMEPLAY_EMOTE_HERO_01A_ERROR_I_ATTACKED	Я уже атаковал.		
GAMEPLAY_EMOTE_HERO_01A_ERROR_JUST_PLAYED	Это существо будет готово атаковать через ход.		
GAMEPLAY_EMOTE_HERO_01A_ERROR_MINION_ATTACKED	Это существо уже атаковало на этом ходу.		
GAMEPLAY_EMOTE_HERO_01A_ERROR_NEED_MANA	Мне не хватает маны.		
GAMEPLAY_EMOTE_HERO_01A_ERROR_NEED_WEAPON	Мне нужно оружие.		
GAMEPLAY_EMOTE_HERO_01A_ERROR_PLAY	Я не могу сыграть эту карту.		
GAMEPLAY_EMOTE_HERO_01A_ERROR_STEALTH	Я не могу выбрать целью замаскированное существо.		
GAMEPLAY_EMOTE_HERO_01A_ERROR_TARGET	Нельзя применить к этой цели.		
GAMEPLAY_EMOTE_HERO_01A_ERROR_TAUNT	Я должен атаковать провокатора.		
GAMEPLAY_EMOTE_HERO_01A_EVENT_LUNAR_NEW_YEAR	Ну, здравствуй.		
GAMEPLAY_EMOTE_HERO_01A_GOOD_GAME	Отличная игра!		
GAMEPLAY_EMOTE_HERO_01A_GREETINGS	О, привет.		
GAMEPLAY_EMOTE_HERO_01A_LOW_CARDS	У меня почти не осталось карт!		
GAMEPLAY_EMOTE_HERO_01A_MIRROR_START	Да, за Каз-Модан!		
GAMEPLAY_EMOTE_HERO_01A_NO_CARDS	У меня кончились карты!		
GAMEPLAY_EMOTE_HERO_01A_OOPS	Что-то пошло не так...		
GAMEPLAY_EMOTE_HERO_01A_SORRY	Мне так жаль, дружище.		
GAMEPLAY_EMOTE_HERO_01A_START	За Каз Модан!		
GAMEPLAY_EMOTE_HERO_01A_THANKS	А, спасибо!		
GAMEPLAY_EMOTE_HERO_01A_THINK1	Хмм...		
GAMEPLAY_EMOTE_HERO_01A_THINK2	Может, так? Нет, нет...		
GAMEPLAY_EMOTE_HERO_01A_THINK3	Такой богатый выбор...		
GAMEPLAY_EMOTE_HERO_01A_THREATEN	Почувствуй ярость горы!		
GAMEPLAY_EMOTE_HERO_01A_TIMER	Эй! Надо что-то делать!		
GAMEPLAY_EMOTE_HERO_01A_WELL_PLAYED	Неплохо сыграно.		
GAMEPLAY_EMOTE_HERO_01A_WINTERVEIL_GREETINGS	Счастливого праздника Зимнего Покрова!		
GAMEPLAY_EMOTE_HERO_01A_WOW	Клянусь бородой!		
GAMEPLAY_EMOTE_HERO_02_CONCEDE	Победа за тобой, друг.		
GAMEPLAY_EMOTE_HERO_02_ERROR_FULL_MINIONS	У меня слишком много существ.		
GAMEPLAY_EMOTE_HERO_02_ERROR_GENERIC	Я не могу это сделать.		
GAMEPLAY_EMOTE_HERO_02_ERROR_HAND_FULL	В моей руке слишком много карт!		
GAMEPLAY_EMOTE_HERO_02_ERROR_I_ATTACKED	Я уже атаковал.		
GAMEPLAY_EMOTE_HERO_02_ERROR_JUST_PLAYED	Это существо сможет атаковать в мой следующий ход.		
GAMEPLAY_EMOTE_HERO_02_ERROR_MINION_ATTACKED	Это существо уже атаковало в этот ход.		
GAMEPLAY_EMOTE_HERO_02_ERROR_NEED_MANA	Мне не хватает маны.		
GAMEPLAY_EMOTE_HERO_02_ERROR_NEED_WEAPON	Мне нужно оружие.		
GAMEPLAY_EMOTE_HERO_02_ERROR_PLAY	Я не могу разыграть эту карту.		
GAMEPLAY_EMOTE_HERO_02_ERROR_STEALTH	Я не могу выбрать целью замаскированное существо.		
GAMEPLAY_EMOTE_HERO_02_ERROR_TARGET	Нельзя применить к этой цели.		
GAMEPLAY_EMOTE_HERO_02_ERROR_TAUNT	Я должен атаковать провокатора!		
GAMEPLAY_EMOTE_HERO_02_EVENT_LUNAR_NEW_YEAR	Ну, здравствуй.		
GAMEPLAY_EMOTE_HERO_02_GOOD_GAME	Отличная игра!		
GAMEPLAY_EMOTE_HERO_02_GREETINGS	Приветствую тебя!		
GAMEPLAY_EMOTE_HERO_02_LOW_CARDS	У меня скоро кончатся карты!		
GAMEPLAY_EMOTE_HERO_02_MIRROR_START	За Северных Волков!		
GAMEPLAY_EMOTE_HERO_02_NO_CARDS	У меня кончились карты!		
GAMEPLAY_EMOTE_HERO_02_OOPS	Это было ошибкой.		
GAMEPLAY_EMOTE_HERO_02_SORRY	Извини, что так произошло.		
GAMEPLAY_EMOTE_HERO_02_START	За Молот Рока!		
GAMEPLAY_EMOTE_HERO_02_THANKS	Я благодарю тебя.		
GAMEPLAY_EMOTE_HERO_02_THINK1	Хм...		
GAMEPLAY_EMOTE_HERO_02_THINK2	Интересно...		
GAMEPLAY_EMOTE_HERO_02_THINK3	Хм... Что же делать...		
GAMEPLAY_EMOTE_HERO_02_THREATEN	Стихии уничтожат тебя.		
GAMEPLAY_EMOTE_HERO_02_TIMER	Времени мало!		
GAMEPLAY_EMOTE_HERO_02_WELL_PLAYED	Неплохо сыграно.		
GAMEPLAY_EMOTE_HERO_02_WINTERVEIL_GREETINGS	Счастливого праздника Зимнего Покрова!		
GAMEPLAY_EMOTE_HERO_02_WOW	Это невероятно!		
GAMEPLAY_EMOTE_HERO_03_CONCEDE	Я сдаюсь.		
GAMEPLAY_EMOTE_HERO_03_ERROR_FULL_MINIONS	У меня слишком много существ.		
GAMEPLAY_EMOTE_HERO_03_ERROR_GENERIC	Я не могу это сделать.		
GAMEPLAY_EMOTE_HERO_03_ERROR_HAND_FULL	У меня в руке слишком много карт!		
GAMEPLAY_EMOTE_HERO_03_ERROR_I_ATTACKED	Я уже атаковала.		
GAMEPLAY_EMOTE_HERO_03_ERROR_JUST_PLAYED	Это существо сможет атаковать в мой следующий ход.		
GAMEPLAY_EMOTE_HERO_03_ERROR_MINION_ATTACKED	Это существо уже атаковало в этот ход.		
GAMEPLAY_EMOTE_HERO_03_ERROR_NEED_MANA	Мне не хватает маны.		
GAMEPLAY_EMOTE_HERO_03_ERROR_NEED_WEAPON	Мне нужно оружие.		
GAMEPLAY_EMOTE_HERO_03_ERROR_PLAY	Я не могу разыграть эту карту.		
GAMEPLAY_EMOTE_HERO_03_ERROR_STEALTH	Я не могу выбрать целью замаскированное существо.		
GAMEPLAY_EMOTE_HERO_03_ERROR_TARGET	Нельзя применить к этой цели.		
GAMEPLAY_EMOTE_HERO_03_ERROR_TAUNT	Я должна атаковать провокатора.		
GAMEPLAY_EMOTE_HERO_03_EVENT_LUNAR_NEW_YEAR	Мое почтение.		
GAMEPLAY_EMOTE_HERO_03_GOOD_GAME	Отличная игра!		
GAMEPLAY_EMOTE_HERO_03_GREETINGS	Мое почтение.		
GAMEPLAY_EMOTE_HERO_03_LOW_CARDS	У меня скоро кончатся карты!		
GAMEPLAY_EMOTE_HERO_03_MIRROR_START	Разумеется.		
GAMEPLAY_EMOTE_HERO_03_NO_CARDS	У меня кончились карты!		
GAMEPLAY_EMOTE_HERO_03_OOPS	Ошибки случаются...		
GAMEPLAY_EMOTE_HERO_03_SORRY	Мне жаль.		
GAMEPLAY_EMOTE_HERO_03_START	Будь начеку.		
GAMEPLAY_EMOTE_HERO_03_THANKS	Спасибо.		
GAMEPLAY_EMOTE_HERO_03_THINK1	Хм...		
GAMEPLAY_EMOTE_HERO_03_THINK2	Интересно...		
GAMEPLAY_EMOTE_HERO_03_THINK3	Так много вариантов...		
GAMEPLAY_EMOTE_HERO_03_THREATEN	Я – твоя погибель!		
GAMEPLAY_EMOTE_HERO_03_TIMER	Мне надо решиться...		
GAMEPLAY_EMOTE_HERO_03_WELL_PLAYED	Неплохо сыграно.		
GAMEPLAY_EMOTE_HERO_03_WINTERVEIL_GREETINGS	Счастливого праздника Зимнего Покрова!		
GAMEPLAY_EMOTE_HERO_03_WOW	Невероятно.		
GAMEPLAY_EMOTE_HERO_04_CONCEDE	Победа за тобой.		
GAMEPLAY_EMOTE_HERO_04_ERROR_FULL_MINIONS	У меня слишком много существ.		
GAMEPLAY_EMOTE_HERO_04_ERROR_GENERIC	Я не могу это сделать.		
GAMEPLAY_EMOTE_HERO_04_ERROR_HAND_FULL	В моей руке слишком много карт!		
GAMEPLAY_EMOTE_HERO_04_ERROR_I_ATTACKED	Я уже атаковал.		
GAMEPLAY_EMOTE_HERO_04_ERROR_JUST_PLAYED	Это существо сможет атаковать в мой следующий ход.		
GAMEPLAY_EMOTE_HERO_04_ERROR_MINION_ATTACKED	Это существо уже атаковало в этот ход.		
GAMEPLAY_EMOTE_HERO_04_ERROR_NEED_MANA	Мне не хватает маны.		
GAMEPLAY_EMOTE_HERO_04_ERROR_NEED_WEAPON	Мне нужно оружие.		
GAMEPLAY_EMOTE_HERO_04_ERROR_PLAY	Я не могу разыграть эту карту.		
GAMEPLAY_EMOTE_HERO_04_ERROR_STEALTH	Я не могу выбрать целью замаскированное существо.		
GAMEPLAY_EMOTE_HERO_04_ERROR_TARGET	Нельзя применить к этой цели.		
GAMEPLAY_EMOTE_HERO_04_ERROR_TAUNT	Я должен атаковать провокатора.		
GAMEPLAY_EMOTE_HERO_04_EVENT_LUNAR_NEW_YEAR	Какая встреча!		
GAMEPLAY_EMOTE_HERO_04_GOOD_GAME	Отличная игра!		
GAMEPLAY_EMOTE_HERO_04_GREETINGS	Какая встреча!		
GAMEPLAY_EMOTE_HERO_04_LOW_CARDS	У меня скоро кончатся карты!		
GAMEPLAY_EMOTE_HERO_04_MIRROR_START	Да поможет мне Свет!		
GAMEPLAY_EMOTE_HERO_04_NO_CARDS	У меня кончились карты!		
GAMEPLAY_EMOTE_HERO_04_OOPS	Это была ошибка.		
GAMEPLAY_EMOTE_HERO_04_SORRY	Извини.		
GAMEPLAY_EMOTE_HERO_04_START	Я буду сражаться с честью!		
GAMEPLAY_EMOTE_HERO_04_THANKS	Спасибо.		
GAMEPLAY_EMOTE_HERO_04_THINK1	Хм...		
GAMEPLAY_EMOTE_HERO_04_THINK2	Интересно...		
GAMEPLAY_EMOTE_HERO_04_THINK3	Дай мне подумать...		
GAMEPLAY_EMOTE_HERO_04_THREATEN	Справедливость должна быть восстановлена!		
GAMEPLAY_EMOTE_HERO_04_TIMER	Мне надо действовать быстрее.		
GAMEPLAY_EMOTE_HERO_04_WELL_PLAYED	Неплохо сыграно.		
GAMEPLAY_EMOTE_HERO_04_WINTERVEIL_GREETINGS	Счастливого праздника Зимнего Покрова, герой!		
GAMEPLAY_EMOTE_HERO_04_WOW	Во имя Света!		
GAMEPLAY_EMOTE_HERO_04A_CONCEDE	Победа за тобой. Я сдаюсь.		
GAMEPLAY_EMOTE_HERO_04A_ERROR_FULL_MINIONS	У меня слишком много существ.		
GAMEPLAY_EMOTE_HERO_04A_ERROR_GENERIC	Я не могу это сделать.		
GAMEPLAY_EMOTE_HERO_04A_ERROR_HAND_FULL	В моей руке слишком много карт!		
GAMEPLAY_EMOTE_HERO_04A_ERROR_I_ATTACKED	Я уже атаковала.		
GAMEPLAY_EMOTE_HERO_04A_ERROR_JUST_PLAYED	Это существо будет готово атаковать через ход.		
GAMEPLAY_EMOTE_HERO_04A_ERROR_MINION_ATTACKED	Это существо уже атаковало на этом ходу.		
GAMEPLAY_EMOTE_HERO_04A_ERROR_NEED_MANA	Мне не хватает маны.		
GAMEPLAY_EMOTE_HERO_04A_ERROR_NEED_WEAPON	Мне нужно оружие.		
GAMEPLAY_EMOTE_HERO_04A_ERROR_PLAY	Я не могу сыграть эту карту.		
GAMEPLAY_EMOTE_HERO_04A_ERROR_STEALTH	Я не могу выбрать целью замаскированное существо.		
GAMEPLAY_EMOTE_HERO_04A_ERROR_TARGET	Нельзя применить к этой цели.		
GAMEPLAY_EMOTE_HERO_04A_ERROR_TAUNT	Я должна атаковать провокатора.		
GAMEPLAY_EMOTE_HERO_04A_GOOD_GAME	Отличная игра!		
GAMEPLAY_EMOTE_HERO_04A_GREETINGS	Ах, приветствую!		
GAMEPLAY_EMOTE_HERO_04A_LOW_CARDS	У меня почти не осталось карт!		
GAMEPLAY_EMOTE_HERO_04A_LUNAR_NEW_YEAR	Ах, приветствую!		
GAMEPLAY_EMOTE_HERO_04A_MIRROR_START	Священный огонь — мое второе имя.		
GAMEPLAY_EMOTE_HERO_04A_NO_CARDS	У меня кончились карты!		
GAMEPLAY_EMOTE_HERO_04A_OOPS	Это, конечно же, была ошибка.		
GAMEPLAY_EMOTE_HERO_04A_SORRY	Ах, прими мои извинения.		
GAMEPLAY_EMOTE_HERO_04A_START	Мой молот пылает священным огнем!		
GAMEPLAY_EMOTE_HERO_04A_THANKS	Я тебе искренне благодарна.		
GAMEPLAY_EMOTE_HERO_04A_THINK1	Хмм...		
GAMEPLAY_EMOTE_HERO_04A_THINK2	Непростой выбор.		
GAMEPLAY_EMOTE_HERO_04A_THINK3	А может быть...		
GAMEPLAY_EMOTE_HERO_04A_THREATEN	Ты поплатишься за свою дерзость!		
GAMEPLAY_EMOTE_HERO_04A_TIMER	Пора ходить!		
GAMEPLAY_EMOTE_HERO_04A_WELL_PLAYED	Неплохо сыграно.		
GAMEPLAY_EMOTE_HERO_04A_WINTERVEIL_GREETINGS	Счастливого праздника Зимнего Покрова!		
GAMEPLAY_EMOTE_HERO_04A_WOW	Это невероятно!		
GAMEPLAY_EMOTE_HERO_05_CONCEDE	Хорошая игра. Я сдаюсь.		
GAMEPLAY_EMOTE_HERO_05_ERROR_FULL_MINIONS	У меня слишком много существ.		
GAMEPLAY_EMOTE_HERO_05_ERROR_GENERIC	Я не могу это сделать.		
GAMEPLAY_EMOTE_HERO_05_ERROR_HAND_FULL	В моей руке слишком много карт!		
GAMEPLAY_EMOTE_HERO_05_ERROR_I_ATTACKED	Я уже атаковал.		
GAMEPLAY_EMOTE_HERO_05_ERROR_JUST_PLAYED	Это существо сможет атаковать только в мой следующий ход.		
GAMEPLAY_EMOTE_HERO_05_ERROR_MINION_ATTACKED	Это существо уже атаковало в этот ход.		
GAMEPLAY_EMOTE_HERO_05_ERROR_NEED_MANA	Мне не хватает маны.		
GAMEPLAY_EMOTE_HERO_05_ERROR_NEED_WEAPON	Мне нужно оружие.		
GAMEPLAY_EMOTE_HERO_05_ERROR_PLAY	Я не могу разыграть эту карту.		
GAMEPLAY_EMOTE_HERO_05_ERROR_STEALTH	Не могу выбрать целью замаскированное существо.		
GAMEPLAY_EMOTE_HERO_05_ERROR_TARGET	Нельзя применить к этой цели.		
GAMEPLAY_EMOTE_HERO_05_ERROR_TAUNT	Я должен атаковать провокатора.		
GAMEPLAY_EMOTE_HERO_05_EVENT_LUNAR_NEW_YEAR	Здравствуй.		
GAMEPLAY_EMOTE_HERO_05_GOOD_GAME	Отличная игра!		
GAMEPLAY_EMOTE_HERO_05_GREETINGS	Здравствуй.		
GAMEPLAY_EMOTE_HERO_05_LOW_CARDS	У меня скоро кончатся карты!		
GAMEPLAY_EMOTE_HERO_05_MIRROR_START	Охотник здесь я!		
GAMEPLAY_EMOTE_HERO_05_NO_CARDS	У меня кончились карты!		
GAMEPLAY_EMOTE_HERO_05_OOPS	Не лучший ход...		
GAMEPLAY_EMOTE_HERO_05_SORRY	Прими мои извинения.		
GAMEPLAY_EMOTE_HERO_05_START	Да начнется охота!		
GAMEPLAY_EMOTE_HERO_05_THANKS	Спасибо.		
GAMEPLAY_EMOTE_HERO_05_THINK1	Хм...		
GAMEPLAY_EMOTE_HERO_05_THINK2	Интересно...		
GAMEPLAY_EMOTE_HERO_05_THINK3	Хммммм...		
GAMEPLAY_EMOTE_HERO_05_THREATEN	Я не промахнусь!		
GAMEPLAY_EMOTE_HERO_05_TIMER	Время истекает!		
GAMEPLAY_EMOTE_HERO_05_WELL_PLAYED	Неплохо.		
GAMEPLAY_EMOTE_HERO_05_WINTERVEIL_GREETINGS	Счастливого праздника Зимнего Покрова!		
GAMEPLAY_EMOTE_HERO_05_WOW	Потрясающе!		
GAMEPLAY_EMOTE_HERO_05A_CONCEDE	Мастерская игра! Я сдаюсь.		
GAMEPLAY_EMOTE_HERO_05A_ERROR_FULL_MINIONS	У меня слишком много существ.		
GAMEPLAY_EMOTE_HERO_05A_ERROR_GENERIC	Я не могу это сделать.		
GAMEPLAY_EMOTE_HERO_05A_ERROR_HAND_FULL	В моей руке слишком много карт!		
GAMEPLAY_EMOTE_HERO_05A_ERROR_I_ATTACKED	Я уже атаковала.		
GAMEPLAY_EMOTE_HERO_05A_ERROR_JUST_PLAYED	Это существо будет готово атаковать через ход.		
GAMEPLAY_EMOTE_HERO_05A_ERROR_MINION_ATTACKED	Это существо уже атаковало на этом ходу.		
GAMEPLAY_EMOTE_HERO_05A_ERROR_NEED_MANA	Мне не хватает маны.		
GAMEPLAY_EMOTE_HERO_05A_ERROR_NEED_WEAPON	Мне нужно оружие.		
GAMEPLAY_EMOTE_HERO_05A_ERROR_PLAY	Я не могу сыграть эту карту.		
GAMEPLAY_EMOTE_HERO_05A_ERROR_STEALTH	Я не могу выбрать целью замаскированное существо.		
GAMEPLAY_EMOTE_HERO_05A_ERROR_TARGET	Нельзя применить к этой цели.		
GAMEPLAY_EMOTE_HERO_05A_ERROR_TAUNT	Я должна атаковать провокатора.		
GAMEPLAY_EMOTE_HERO_05A_EVENT_LUNAR_NEW_YEAR	Здравствуй.		
GAMEPLAY_EMOTE_HERO_05A_GOOD_GAME	Отличная игра!		
GAMEPLAY_EMOTE_HERO_05A_GREETINGS	Здравствуй, путник.		
GAMEPLAY_EMOTE_HERO_05A_LOW_CARDS	У меня почти не осталось карт!		
GAMEPLAY_EMOTE_HERO_05A_MIRROR_START	Я ни перед кем не трепещу.		
GAMEPLAY_EMOTE_HERO_05A_NO_CARDS	У меня кончились карты!		
GAMEPLAY_EMOTE_HERO_05A_OOPS	Хм, это ошибка.		
GAMEPLAY_EMOTE_HERO_05A_SORRY	Мои извинения.		
GAMEPLAY_EMOTE_HERO_05A_START	Трепещи перед силой эльфов!		
GAMEPLAY_EMOTE_HERO_05A_THANKS	Спасибо.		
GAMEPLAY_EMOTE_HERO_05A_THINK1	Хмм...		
GAMEPLAY_EMOTE_HERO_05A_THINK2	Кого бы пристрелить?		
GAMEPLAY_EMOTE_HERO_05A_THINK3	Что мне делать?		
GAMEPLAY_EMOTE_HERO_05A_THREATEN	Я тебя уничтожу!		
GAMEPLAY_EMOTE_HERO_05A_TIMER	Ну же! Надо что-то делать!		
GAMEPLAY_EMOTE_HERO_05A_WELL_PLAYED	Неплохо сыграно.		
GAMEPLAY_EMOTE_HERO_05A_WINTERVEIL_GREETING	Счастливого праздника Зимнего Покрова!		
GAMEPLAY_EMOTE_HERO_05A_WOW	Невероятно!		
GAMEPLAY_EMOTE_HERO_06_CONCEDE	Я сдаюсь.		
GAMEPLAY_EMOTE_HERO_06_ERROR_FULL_MINIONS	У меня слишком много существ.		
GAMEPLAY_EMOTE_HERO_06_ERROR_GENERIC	Я не могу это сделать.		
GAMEPLAY_EMOTE_HERO_06_ERROR_HAND_FULL	В моей руке слишком много карт!		
GAMEPLAY_EMOTE_HERO_06_ERROR_I_ATTACKED	Я уже атаковал.		
GAMEPLAY_EMOTE_HERO_06_ERROR_JUST_PLAYED	Это существо сможет атаковать в мой следующий ход.		
GAMEPLAY_EMOTE_HERO_06_ERROR_MINION_ATTACKED	Это существо уже атаковало в этот ход.		
GAMEPLAY_EMOTE_HERO_06_ERROR_NEED_MANA	Мне не хватает маны.		
GAMEPLAY_EMOTE_HERO_06_ERROR_NEED_WEAPON	Мне нужно оружие.		
GAMEPLAY_EMOTE_HERO_06_ERROR_PLAY	Я не могу разыграть эту карту.		
GAMEPLAY_EMOTE_HERO_06_ERROR_STEALTH	Я не могу выбрать целью замаскированное существо.		
GAMEPLAY_EMOTE_HERO_06_ERROR_TARGET	Нельзя применить к этой цели.		
GAMEPLAY_EMOTE_HERO_06_ERROR_TAUNT	Я должен атаковать провокатора.		
GAMEPLAY_EMOTE_HERO_06_EVENT_LUNAR_NEW_YEAR	Здравствуй.		
GAMEPLAY_EMOTE_HERO_06_GOOD_GAME	Отличная игра!		
GAMEPLAY_EMOTE_HERO_06_GREETINGS	Здравствуй.		
GAMEPLAY_EMOTE_HERO_06_LOW_CARDS	У меня скоро кончатся карты!		
GAMEPLAY_EMOTE_HERO_06_MIRROR_START	Защищать природу — наш долг!		
GAMEPLAY_EMOTE_HERO_06_NO_CARDS	У меня кончились карты!		
GAMEPLAY_EMOTE_HERO_06_OOPS	Ошибиться было нетрудно.		
GAMEPLAY_EMOTE_HERO_06_SORRY	Ну, извини.		
GAMEPLAY_EMOTE_HERO_06_START	Я должен защитить природу!		
GAMEPLAY_EMOTE_HERO_06_THANKS	Спасибо тебе.		
GAMEPLAY_EMOTE_HERO_06_THINK1	Хм...		
GAMEPLAY_EMOTE_HERO_06_THINK2	Хмм... Интересно...		
GAMEPLAY_EMOTE_HERO_06_THINK3	Что же мне делать...		
GAMEPLAY_EMOTE_HERO_06_THREATEN	Сама природа восстанет против тебя!		
GAMEPLAY_EMOTE_HERO_06_TIMER	Время никого не ждет...		
GAMEPLAY_EMOTE_HERO_06_WELL_PLAYED	Неплохо сыграно.		
GAMEPLAY_EMOTE_HERO_06_WINTERVEIL_GREETINGS	Счастливого праздника Зимнего Покрова!		
GAMEPLAY_EMOTE_HERO_06_WOW	Впечатляет!		
GAMEPLAY_EMOTE_HERO_07_CONCEDE	На этот раз победа за тобой...		
GAMEPLAY_EMOTE_HERO_07_ERROR_FULL_MINIONS	У меня слишком много существ.		
GAMEPLAY_EMOTE_HERO_07_ERROR_GENERIC	Я не могу это сделать.		
GAMEPLAY_EMOTE_HERO_07_ERROR_HAND_FULL	В моей руке слишком много карт!		
GAMEPLAY_EMOTE_HERO_07_ERROR_I_ATTACKED	Я уже атаковал.		
GAMEPLAY_EMOTE_HERO_07_ERROR_JUST_PLAYED	Это существо сможет атаковать в мой следующий ход.		
GAMEPLAY_EMOTE_HERO_07_ERROR_MINION_ATTACKED	Это существо уже атаковало в этот ход.		
GAMEPLAY_EMOTE_HERO_07_ERROR_NEED_MANA	Мне не хватает маны.		
GAMEPLAY_EMOTE_HERO_07_ERROR_NEED_WEAPON	Мне нужно оружие.		
GAMEPLAY_EMOTE_HERO_07_ERROR_PLAY	Я не могу разыграть эту карту.		
GAMEPLAY_EMOTE_HERO_07_ERROR_STEALTH	Я не могу выбрать целью замаскированное существо.		
GAMEPLAY_EMOTE_HERO_07_ERROR_TARGET	Нельзя применить к этой цели.		
GAMEPLAY_EMOTE_HERO_07_ERROR_TAUNT	Я должен атаковать провокатора.		
GAMEPLAY_EMOTE_HERO_07_EVENT_LUNAR_NEW_YEAR	Приветствую тебя.		
GAMEPLAY_EMOTE_HERO_07_GOOD_GAME	Отличная игра!		
GAMEPLAY_EMOTE_HERO_07_GREETINGS	Приветствую тебя.		
GAMEPLAY_EMOTE_HERO_07_LOW_CARDS	У меня скоро кончатся карты!		
GAMEPLAY_EMOTE_HERO_07_MIRROR_START	Я – твой худший кошмар!		
GAMEPLAY_EMOTE_HERO_07_NO_CARDS	У меня кончились карты!		
GAMEPLAY_EMOTE_HERO_07_OOPS	Это была ошибка.		
GAMEPLAY_EMOTE_HERO_07_SORRY	Мне жаль.		
GAMEPLAY_EMOTE_HERO_07_START	Твоя душа будет моей!		
GAMEPLAY_EMOTE_HERO_07_THANKS	Благодарю.		
GAMEPLAY_EMOTE_HERO_07_THINK1	Хм...		
GAMEPLAY_EMOTE_HERO_07_THINK2	Интересно...		
GAMEPLAY_EMOTE_HERO_07_THINK3	Так много возможностей...		
GAMEPLAY_EMOTE_HERO_07_THREATEN	Твоя душа познает муки!		
GAMEPLAY_EMOTE_HERO_07_TIMER	Мое время почти истекло!		
GAMEPLAY_EMOTE_HERO_07_WELL_PLAYED	Достойно.		
GAMEPLAY_EMOTE_HERO_07_WINTERVEIL_GREETINGS	Счастливого праздника Зимнего Покрова!		
GAMEPLAY_EMOTE_HERO_07_WOW	Потрясающе!		
GAMEPLAY_EMOTE_HERO_08_CONCEDE	Эта партия за тобой...		
GAMEPLAY_EMOTE_HERO_08_ERROR_FULL_MINIONS	У меня слишком много существ.		
GAMEPLAY_EMOTE_HERO_08_ERROR_GENERIC	Я не могу это сделать.		
GAMEPLAY_EMOTE_HERO_08_ERROR_HAND_FULL	В моей руке слишком много карт!		
GAMEPLAY_EMOTE_HERO_08_ERROR_I_ATTACKED	Я уже атаковала.		
GAMEPLAY_EMOTE_HERO_08_ERROR_JUST_PLAYED	Это существо сможет атаковать в мой следующий ход.		
GAMEPLAY_EMOTE_HERO_08_ERROR_MINION_ATTACKED	Это существо уже атаковало в этот ход.		
GAMEPLAY_EMOTE_HERO_08_ERROR_NEED_MANA	Мне не хватает маны.		
GAMEPLAY_EMOTE_HERO_08_ERROR_NEED_WEAPON	Мне нужно оружие.		
GAMEPLAY_EMOTE_HERO_08_ERROR_PLAY	Я не могу разыграть эту карту.		
GAMEPLAY_EMOTE_HERO_08_ERROR_STEALTH	Я не могу выбрать целью замаскированное существо.		
GAMEPLAY_EMOTE_HERO_08_ERROR_TARGET	Нельзя применить к этой цели.		
GAMEPLAY_EMOTE_HERO_08_ERROR_TAUNT	Я должна атаковать провокатора.		
GAMEPLAY_EMOTE_HERO_08_EVENT_LUNAR_NEW_YEAR	Здравствуй!		
GAMEPLAY_EMOTE_HERO_08_GOOD_GAME	Отличная игра!		
GAMEPLAY_EMOTE_HERO_08_GREETINGS	Здравствуй!		
GAMEPLAY_EMOTE_HERO_08_LOW_CARDS	У меня скоро кончатся карты!		
GAMEPLAY_EMOTE_HERO_08_MIRROR_START	Это мы еще увидим.		
GAMEPLAY_EMOTE_HERO_08_NO_CARDS	У меня кончились карты!		
GAMEPLAY_EMOTE_HERO_08_OOPS	Ну надо же...		
GAMEPLAY_EMOTE_HERO_08_SORRY	Прошу прощения.		
GAMEPLAY_EMOTE_HERO_08_START	Не стоило напрашиваться.		
GAMEPLAY_EMOTE_HERO_08_THANKS	Спасибо!		
GAMEPLAY_EMOTE_HERO_08_THINK1	Хм...		
GAMEPLAY_EMOTE_HERO_08_THINK2	Интересно...		
GAMEPLAY_EMOTE_HERO_08_THINK3	Что же делать...		
GAMEPLAY_EMOTE_HERO_08_THREATEN	Моя магия сокрушит тебя!		
GAMEPLAY_EMOTE_HERO_08_TIMER	У меня кончается время...		
GAMEPLAY_EMOTE_HERO_08_WELL_PLAYED	Неплохо сыграно.		
GAMEPLAY_EMOTE_HERO_08_WINTERVEIL_GREETINGS	Счастливого праздника Зимнего Покрова!		
GAMEPLAY_EMOTE_HERO_08_WOW	Удивительно.		
GAMEPLAY_EMOTE_HERO_08A_CONCEDE	Шах и мат! Отлично сыграно.		
GAMEPLAY_EMOTE_HERO_08A_ERROR_FULL_MINIONS	У меня слишком много существ.		
GAMEPLAY_EMOTE_HERO_08A_ERROR_GENERIC	Я не могу это сделать.		
GAMEPLAY_EMOTE_HERO_08A_ERROR_HAND_FULL	В моей руке слишком много карт!		
GAMEPLAY_EMOTE_HERO_08A_ERROR_I_ATTACKED	Я уже атаковал.		
GAMEPLAY_EMOTE_HERO_08A_ERROR_JUST_PLAYED	Это существо будет готово атаковать через ход.		
GAMEPLAY_EMOTE_HERO_08A_ERROR_MINION_ATTACKED	Это существо уже атаковало на этом ходу.		
GAMEPLAY_EMOTE_HERO_08A_ERROR_NEED_MANA	Мне не хватает маны.		
GAMEPLAY_EMOTE_HERO_08A_ERROR_NEED_WEAPON	Мне нужно оружие.		
GAMEPLAY_EMOTE_HERO_08A_ERROR_PLAY	Я не могу сыграть эту карту.		
GAMEPLAY_EMOTE_HERO_08A_ERROR_STEALTH	Я не могу выбрать целью замаскированное существо.		
GAMEPLAY_EMOTE_HERO_08A_ERROR_TARGET	Нельзя применить к этой цели.		
GAMEPLAY_EMOTE_HERO_08A_ERROR_TAUNT	Я должен атаковать провокатора.		
GAMEPLAY_EMOTE_HERO_08A_GOOD_GAME	Отличная игра!		
GAMEPLAY_EMOTE_HERO_08A_GREETINGS	Ах, приветствую.		
GAMEPLAY_EMOTE_HERO_08A_LOW_CARDS	У меня почти не осталось карт!		
GAMEPLAY_EMOTE_HERO_08A_LUNAR_NEW_YEAR	Ах, приветствую.		
GAMEPLAY_EMOTE_HERO_08A_MIRROR_START	О, мы уже начали.		
GAMEPLAY_EMOTE_HERO_08A_NO_CARDS	У меня кончились карты!		
GAMEPLAY_EMOTE_HERO_08A_OOPS	Это было глупо.		
GAMEPLAY_EMOTE_HERO_08A_SORRY	Прими мои искренние извинения.		
GAMEPLAY_EMOTE_HERO_08A_START	Да начнется игра!		
GAMEPLAY_EMOTE_HERO_08A_THANKS	Я это ценю.		
GAMEPLAY_EMOTE_HERO_08A_THINK1	Хмм...		
GAMEPLAY_EMOTE_HERO_08A_THINK2	Интересно...		
GAMEPLAY_EMOTE_HERO_08A_THINK3	Может быть....		
GAMEPLAY_EMOTE_HERO_08A_THREATEN	Меня ничто не остановит! Ничто!		
GAMEPLAY_EMOTE_HERO_08A_TIMER	Мне нельзя медлить!		
GAMEPLAY_EMOTE_HERO_08A_WELL_PLAYED	Неплохо сыграно.		
GAMEPLAY_EMOTE_HERO_08A_WINTERVEIL_GREETINGS	Счастливого праздника Зимнего Покрова!		
GAMEPLAY_EMOTE_HERO_08A_WOW	Потрясающе.		
GAMEPLAY_EMOTE_HERO_08B_CONCEDE	Ты молодец. Победа за тобой.		
GAMEPLAY_EMOTE_HERO_08B_ERROR_FULL_MINIONS	У меня слишком много существ.		
GAMEPLAY_EMOTE_HERO_08B_ERROR_GENERIC	Я не могу это сделать.		
GAMEPLAY_EMOTE_HERO_08B_ERROR_HAND_FULL	В моей руке слишком много карт!		
GAMEPLAY_EMOTE_HERO_08B_ERROR_I_ATTACKED	Я уже атаковал.		
GAMEPLAY_EMOTE_HERO_08B_ERROR_JUST_PLAYED	Это существо будет готово атаковать через ход.		
GAMEPLAY_EMOTE_HERO_08B_ERROR_MINION_ATTACKED	Это существо уже атаковало на этом ходу.		
GAMEPLAY_EMOTE_HERO_08B_ERROR_NEED_MANA	Мне не хватает маны.		
GAMEPLAY_EMOTE_HERO_08B_ERROR_NEED_WEAPON	Мне нужно оружие.		
GAMEPLAY_EMOTE_HERO_08B_ERROR_PLAY	Я не могу сыграть эту карту.		
GAMEPLAY_EMOTE_HERO_08B_ERROR_STEALTH	Я не могу выбрать целью замаскированное существо.		
GAMEPLAY_EMOTE_HERO_08B_ERROR_TARGET	Нельзя применить к этой цели.		
GAMEPLAY_EMOTE_HERO_08B_ERROR_TAUNT	Я должен атаковать провокатора.		
GAMEPLAY_EMOTE_HERO_08B_GOOD_GAME	Ну и ну. Отличная была игра!		
GAMEPLAY_EMOTE_HERO_08B_GREETINGS	Здравствуй. Вижу, ты тоже ищешь истину.		
GAMEPLAY_EMOTE_HERO_08B_LOW_CARDS	У меня почти не осталось карт!		
GAMEPLAY_EMOTE_HERO_08B_LUNAR_NEW_YEAR	Здравствуй. Вижу, ты тоже ищешь истину.		
GAMEPLAY_EMOTE_HERO_08B_MIRROR_START	Вместе мы узнаем многое.		
GAMEPLAY_EMOTE_HERO_08B_NO_CARDS	У меня кончились карты!		
GAMEPLAY_EMOTE_HERO_08B_OOPS	Ай-яй-яй…		
GAMEPLAY_EMOTE_HERO_08B_SORRY	Ой, извини.		
GAMEPLAY_EMOTE_HERO_08B_START	Знание – сила.		
GAMEPLAY_EMOTE_HERO_08B_THANKS	Спасибо тебе.		
GAMEPLAY_EMOTE_HERO_08B_THINK1	Хмм…		
GAMEPLAY_EMOTE_HERO_08B_THINK2	Созерцай и мысли…		
GAMEPLAY_EMOTE_HERO_08B_THINK3	Должен быть способ…		
GAMEPLAY_EMOTE_HERO_08B_THREATEN	Пора преподать тебе урок, невежда!		
GAMEPLAY_EMOTE_HERO_08B_TIMER	Время на исходе!		
GAMEPLAY_EMOTE_HERO_08B_WELL_PLAYED	Неплохо сыграно.		
GAMEPLAY_EMOTE_HERO_08B_WINTERVEIL_GREETINGS	Счастливого праздника Зимнего Покрова!		
GAMEPLAY_EMOTE_HERO_08B_WOW	Превосходно.		
GAMEPLAY_EMOTE_HERO_09_CONCEDE	Ты сильнее меня.		
GAMEPLAY_EMOTE_HERO_09_ERROR_FULL_MINIONS	У меня слишком много существ.		
GAMEPLAY_EMOTE_HERO_09_ERROR_GENERIC	Я не могу это сделать.		
GAMEPLAY_EMOTE_HERO_09_ERROR_HAND_FULL	В моей руке слишком много карт!		
GAMEPLAY_EMOTE_HERO_09_ERROR_I_ATTACKED	Я уже атаковал.		
GAMEPLAY_EMOTE_HERO_09_ERROR_JUST_PLAYED	Это существо сможет атаковать в мой следующий ход.		
GAMEPLAY_EMOTE_HERO_09_ERROR_MINION_ATTACKED	Это существо уже атаковало в этот ход.		
GAMEPLAY_EMOTE_HERO_09_ERROR_NEED_MANA	Мне не хватает маны.		
GAMEPLAY_EMOTE_HERO_09_ERROR_NEED_WEAPON	Мне нужно оружие.		
GAMEPLAY_EMOTE_HERO_09_ERROR_PLAY	Я не могу разыграть эту карту.		
GAMEPLAY_EMOTE_HERO_09_ERROR_STEALTH	Я не могу выбрать целью замаскированное существо.		
GAMEPLAY_EMOTE_HERO_09_ERROR_TARGET	Нельзя применить к этой цели.		
GAMEPLAY_EMOTE_HERO_09_ERROR_TAUNT	Я должен атаковать провокатора.		
GAMEPLAY_EMOTE_HERO_09_EVENT_LUNAR_NEW_YEAR	Здравствуй!		
GAMEPLAY_EMOTE_HERO_09_GOOD_GAME	Отличная игра!		
GAMEPLAY_EMOTE_HERO_09_GREETINGS	Приветствую тебя.		
GAMEPLAY_EMOTE_HERO_09_LOW_CARDS	У меня скоро кончатся карты!		
GAMEPLAY_EMOTE_HERO_09_MIRROR_START	Свет озарит достойнейшего!		
GAMEPLAY_EMOTE_HERO_09_NO_CARDS	У меня кончились карты!		
GAMEPLAY_EMOTE_HERO_09_OOPS	Неудачно получилось...		
GAMEPLAY_EMOTE_HERO_09_SORRY	Прими мои извинения.		
GAMEPLAY_EMOTE_HERO_09_START	Свет дарует мне победу!		
GAMEPLAY_EMOTE_HERO_09_THANKS	Благодарю тебя.		
GAMEPLAY_EMOTE_HERO_09_THINK1	Хм...		
GAMEPLAY_EMOTE_HERO_09_THINK2	Интересно...		
GAMEPLAY_EMOTE_HERO_09_THINK3	Надо подумать...		
GAMEPLAY_EMOTE_HERO_09_THREATEN	Свет опалит тебя!		
GAMEPLAY_EMOTE_HERO_09_TIMER	Надо решать быстрее...		
GAMEPLAY_EMOTE_HERO_09_WELL_PLAYED	Неплохо сыграно.		
GAMEPLAY_EMOTE_HERO_09_WINTERVEIL_GREETINGS	Счастливого праздника Зимнего Покрова!		
GAMEPLAY_EMOTE_HERO_09_WOW	Ух ты...		
GAMEPLAY_EMOTE_HERO_TBKTRAF_KT_CONCEDE	Я… вернусь.		
GAMEPLAY_EMOTE_HERO_TBKTRAF_KT_GREETINGS	Наконец-то мы встретились.		
GAMEPLAY_EMOTE_HERO_TBKTRAF_KT_LOW_CARDS	У меня карты кончаются!		
GAMEPLAY_EMOTE_HERO_TBKTRAF_KT_NO_CARDS	Это невозможно! Ты за это еще заплатишь!		
GAMEPLAY_EMOTE_HERO_TBKTRAF_KT_OOPS	Я просто вне себя от гнева. Я весь БУРЛЮ.		
GAMEPLAY_EMOTE_HERO_TBKTRAF_KT_SORRY	Очуметь, какой поганый день!		
GAMEPLAY_EMOTE_HERO_TBKTRAF_KT_START	Иди сюда и сразись со мной!		
GAMEPLAY_EMOTE_HERO_TBKTRAF_KT_THANKS	Эм... Всегда к твоим услугам.		
GAMEPLAY_EMOTE_HERO_TBKTRAF_KT_THINK1	Может быть...		
GAMEPLAY_EMOTE_HERO_TBKTRAF_KT_THINK2	Да... Да!		
GAMEPLAY_EMOTE_HERO_TBKTRAF_KT_THINK3	Что скажешь, Бигглсуорт?		
GAMEPLAY_EMOTE_HERO_TBKTRAF_KT_THREATEN	Я заморожу кровь в твоих жилах!		
GAMEPLAY_EMOTE_HERO_TBKTRAF_KT_WELL_PLAYED	Бррр, а как же я еще мог сыграть?! Я же Кел'Тузад, а не кто попало!		
GAMEPLAY_EMOTE_HERO_TBKTRAF_RAF_CONCEDE	Нет! Меня не победить...		
GAMEPLAY_EMOTE_HERO_TBKTRAF_RAF_GREETINGS	Здравствуй, исследователь.		
GAMEPLAY_EMOTE_HERO_TBKTRAF_RAF_LOW_CARDS	У меня кончаются карты!		
GAMEPLAY_EMOTE_HERO_TBKTRAF_RAF_NO_CARDS	Мои бесценные сокровища!		
GAMEPLAY_EMOTE_HERO_TBKTRAF_RAF_OOPS	Какая ошибка!		
GAMEPLAY_EMOTE_HERO_TBKTRAF_RAF_SORRY	Мне тебя жалко.		
GAMEPLAY_EMOTE_HERO_TBKTRAF_RAF_START	Я – Рафаам, величайший из археологов!		
GAMEPLAY_EMOTE_HERO_TBKTRAF_RAF_THANKS	Ну, спасибо.		
GAMEPLAY_EMOTE_HERO_TBKTRAF_RAF_THINK1	Хм...		
GAMEPLAY_EMOTE_HERO_TBKTRAF_RAF_THINK2	Что же выбрать...		
GAMEPLAY_EMOTE_HERO_TBKTRAF_RAF_THINK3	Какие чудесные карты...		
GAMEPLAY_EMOTE_HERO_TBKTRAF_RAF_THREATEN	Меня переполняет мощь!		
GAMEPLAY_EMOTE_HERO_TBKTRAF_RAF_WELL_PLAYED	Отлично сыграно!		
GAMEPLAY_EMOTE_HERO_TBMECHWAR01_CONCEDE	<Сдаюсь>	The text is in brackets because the VO files is just Annoy-o-Tron's greeting	
GAMEPLAY_EMOTE_HERO_TBMECHWAR01_ERROR_FULL_MINIONS	<Ошибка!>	The text is in brackets because the VO files is just Annoy-o-Tron's greeting	
GAMEPLAY_EMOTE_HERO_TBMECHWAR01_ERROR_HAND_FULL	<Ошибка!>	The text is in brackets because the VO files is just Annoy-o-Tron's greeting	
GAMEPLAY_EMOTE_HERO_TBMECHWAR01_ERROR_I_ATTACKED	<Ошибка!>	The text is in brackets because the VO files is just Annoy-o-Tron's greeting	
GAMEPLAY_EMOTE_HERO_TBMECHWAR01_ERROR_JUST_PLAYED	<Ошибка!>	The text is in brackets because the VO files is just Annoy-o-Tron's greeting	
GAMEPLAY_EMOTE_HERO_TBMECHWAR01_ERROR_MINION_ATTACKED	<Ошибка!>	The text is in brackets because the VO files is just Annoy-o-Tron's greeting	
GAMEPLAY_EMOTE_HERO_TBMECHWAR01_ERROR_NEED_MANA	<Ошибка!>	The text is in brackets because the VO files is just Annoy-o-Tron's greeting	
GAMEPLAY_EMOTE_HERO_TBMECHWAR01_ERROR_NEED_WEAPON	<Ошибка!>	The text is in brackets because the VO files is just Annoy-o-Tron's greeting	
GAMEPLAY_EMOTE_HERO_TBMECHWAR01_ERROR_PLAY	<Ошибка!>	The text is in brackets because the VO files is just Annoy-o-Tron's greeting	
GAMEPLAY_EMOTE_HERO_TBMECHWAR01_ERROR_STEALTH	<Ошибка!>	The text is in brackets because the VO files is just Annoy-o-Tron's greeting	
GAMEPLAY_EMOTE_HERO_TBMECHWAR01_ERROR_TARGET	<Ошибка!>	The text is in brackets because the VO files is just Annoy-o-Tron's greeting	
GAMEPLAY_EMOTE_HERO_TBMECHWAR01_ERROR_TAUNT	<Ошибка!>	The text is in brackets because the VO files is just Annoy-o-Tron's greeting	
GAMEPLAY_EMOTE_HERO_TBMECHWAR01_GREETINGS	<Приветствую>	The text is in brackets because the VO files is just Annoy-o-Tron's greeting	
GAMEPLAY_EMOTE_HERO_TBMECHWAR01_LOW_CARDS	<Мало карт>	The text is in brackets because the VO files is just Annoy-o-Tron's greeting	
GAMEPLAY_EMOTE_HERO_TBMECHWAR01_NO_CARDS	<Нет карт>	The text is in brackets because the VO files is just Annoy-o-Tron's greeting	
GAMEPLAY_EMOTE_HERO_TBMECHWAR01_OOPS	<Ошибка>	The text is in brackets because the VO files is just Annoy-o-Tron's greeting	
GAMEPLAY_EMOTE_HERO_TBMECHWAR01_SORRY	<Приношу извинения>	The text is in brackets because the VO files is just Annoy-o-Tron's greeting	
GAMEPLAY_EMOTE_HERO_TBMECHWAR01_START	<Приступаю>	The text is in brackets because the VO files is just Annoy-o-Tron's greeting	
GAMEPLAY_EMOTE_HERO_TBMECHWAR01_THANKS	<Благодарю>	The text is in brackets because the VO files is just Annoy-o-Tron's greeting	
GAMEPLAY_EMOTE_HERO_TBMECHWAR01_THINK1	<Обрабатываю данные...>	The text is in brackets because the VO files is just Annoy-o-Tron's greeting	
GAMEPLAY_EMOTE_HERO_TBMECHWAR01_THINK2	<Веду поиск цели...>	The text is in brackets because the VO files is just Annoy-o-Tron's greeting	
GAMEPLAY_EMOTE_HERO_TBMECHWAR01_THINK3	<Простаиваю...>	The text is in brackets because the VO files is just Annoy-o-Tron's greeting	
GAMEPLAY_EMOTE_HERO_TBMECHWAR01_THREATEN	<Угрожаю>	The text is in brackets because the VO files is just Annoy-o-Tron's attack	
GAMEPLAY_EMOTE_HERO_TBMECHWAR01_TIMER	<Мало времени>	The text is in brackets because the VO files is just Annoy-o-Tron's greeting	
GAMEPLAY_EMOTE_HERO_TBMECHWAR01_WELL_PLAYED	<Неплохо сыграно>	The text is in brackets because the VO files is just Annoy-o-Tron's greeting	
GAMEPLAY_EMOTE_HERO_TBMECHWAR02_CONCEDE	<Конец строки>	The text is in brackets because the VO files is just Boom Bot's greeting	
GAMEPLAY_EMOTE_HERO_TBMECHWAR02_ERROR_FULL_MINIONS	<Ошибка!>	The text is in brackets because the VO files is just Boom Bot's greeting	
GAMEPLAY_EMOTE_HERO_TBMECHWAR02_ERROR_HAND_FULL	<Ошибка!>	The text is in brackets because the VO files is just Boom Bot's greeting	
GAMEPLAY_EMOTE_HERO_TBMECHWAR02_ERROR_I_ATTACKED	<Ошибка!>	The text is in brackets because the VO files is just Boom Bot's greeting	
GAMEPLAY_EMOTE_HERO_TBMECHWAR02_ERROR_JUST_PLAYED	<Ошибка!>	The text is in brackets because the VO files is just Boom Bot's greeting	
GAMEPLAY_EMOTE_HERO_TBMECHWAR02_ERROR_MINION_ATTACKED	<Ошибка!>	The text is in brackets because the VO files is just Boom Bot's greeting	
GAMEPLAY_EMOTE_HERO_TBMECHWAR02_ERROR_NEED_MANA	<Ошибка!>	The text is in brackets because the VO files is just Boom Bot's greeting	
GAMEPLAY_EMOTE_HERO_TBMECHWAR02_ERROR_NEED_WEAPON	<Ошибка!>	The text is in brackets because the VO files is just Boom Bot's greeting	
GAMEPLAY_EMOTE_HERO_TBMECHWAR02_ERROR_PLAY	<Ошибка!>	The text is in brackets because the VO files is just Boom Bot's greeting	
GAMEPLAY_EMOTE_HERO_TBMECHWAR02_ERROR_STEALTH	<Ошибка!>	The text is in brackets because the VO files is just Boom Bot's greeting	
GAMEPLAY_EMOTE_HERO_TBMECHWAR02_ERROR_TARGET	<Ошибка!>	The text is in brackets because the VO files is just Boom Bot's greeting	
GAMEPLAY_EMOTE_HERO_TBMECHWAR02_ERROR_TAUNT	<Ошибка!>	The text is in brackets because the VO files is just Boom Bot's greeting	
GAMEPLAY_EMOTE_HERO_TBMECHWAR02_GREETINGS	<Приветствую>	The text is in brackets because the VO files is just Annoy-o-Tron's greeting	
GAMEPLAY_EMOTE_HERO_TBMECHWAR02_LOW_CARDS	<Мало карт>	The text is in brackets because the VO files is just Boom Bot's greeting	
GAMEPLAY_EMOTE_HERO_TBMECHWAR02_NO_CARDS	<Нет карт!>	The text is in brackets because the VO files is just Boom Bot's greeting	
GAMEPLAY_EMOTE_HERO_TBMECHWAR02_OOPS	<Ошибка!>	The text is in brackets because the VO files is just Boom Bot's greeting	
GAMEPLAY_EMOTE_HERO_TBMECHWAR02_SORRY	<Прошу прощения>	The text is in brackets because the VO files is just Boom Bot's greeting	
GAMEPLAY_EMOTE_HERO_TBMECHWAR02_START	<Начинаю бой>	The text is in brackets because the VO files is just Boom Bot's greeting	
GAMEPLAY_EMOTE_HERO_TBMECHWAR02_THANKS	<Спасибо>	The text is in brackets because the VO files is just Boom Bot's greeting	
GAMEPLAY_EMOTE_HERO_TBMECHWAR02_THINK1	<Обрабатываю данные...>	The text is in brackets because the VO files is just Boom Bot's greeting	
GAMEPLAY_EMOTE_HERO_TBMECHWAR02_THINK2	<Веду поиск цели...>	The text is in brackets because the VO files is just Boom Bot's greeting	
GAMEPLAY_EMOTE_HERO_TBMECHWAR02_THINK3	<Простаиваю...>	The text is in brackets because the VO files is just Boom Bot's greeting	
GAMEPLAY_EMOTE_HERO_TBMECHWAR02_THREATEN	<Устрашаю!>	The text is in brackets because the VO files is just Boom Bot's Attack sound	
GAMEPLAY_EMOTE_HERO_TBMECHWAR02_TIMER	<Мало времени>	The text is in brackets because the VO files is just Boom Bot's greeting	
GAMEPLAY_EMOTE_HERO_TBMECHWAR02_WELL_PLAYED	<Неплохо сыграно>	The text is in brackets because the VO files is just Boom Bot's greeting	
VO_BRM_027h__LUNAR_NEW_YEAR	ОЧИСТИТЕСЬ ОГНЕМ!		
VO_BRM_027h_Attack_15	ОТВЕДАЙТЕ ПЛАМЯ СУЛЬФУРОНА!		
VO_BRM_027h_Concede_11	ПОБЕДА ЗА ТОБОЙ.		
VO_BRM_027h_Emote_Start	Я отомщу тебе, дракон!		
VO_BRM_027h_ERROR01_51	МНЕ НУЖНО ОРУЖИЕ.		
VO_BRM_027h_ERROR02_52	НЕДОСТАТОЧНО МАНЫ.		
VO_BRM_027h_ERROR03_53	ЭТО СУЩЕСТВО УЖЕ АТАКОВАЛО.		
VO_BRM_027h_ERROR04_54	Я УЖЕ АТАКОВАЛ.		
VO_BRM_027h_ERROR05_55	ЭТО СУЩЕСТВО СМОЖЕТ АТАКОВАТЬ В МОЙ СЛЕДУЮЩИЙ ХОД.		
VO_BRM_027h_ERROR06_56	СЛИШКОМ МНОГО КАРТ.		
VO_BRM_027h_ERROR07_57	СЛИШКОМ МНОГО СУЩЕСТВ.		
VO_BRM_027h_ERROR08_58	ЭТО СУЩЕСТВО МАСКИРУЕТСЯ.		
VO_BRM_027h_ERROR09_59	НЕ МОГУ РАЗЫГРАТЬ ЭТУ КАРТУ.		
VO_BRM_027h_ERROR10_60	НЕПРАВИЛЬНАЯ ЦЕЛЬ.		
VO_BRM_027h_ERROR11_61	ЭТОТ ПРОВОКАТОР СТОИТ У МЕНЯ НА ПУТИ.		
VO_BRM_027h_ERROR12_62	НЕ МОГУ.		
VO_BRM_027h_GG_16	ХОРОШАЯ ИГРА!		
VO_BRM_027h_Greetings_04	ОЧИСТИТЕСЬ ОГНЕМ!		
VO_BRM_027h_HAPPY_NEW_YEAR_38	Я УВИЖУ НОВЫЙ ГОД В ОГНЕ!		
VO_BRM_027h_LowCards_49	Я СЖЕГ ПОЧТИ ВСЕ СВОИ КАРТЫ.		
VO_BRM_027h_NoCards_50	ВСЕ МОИ КАРТЫ СГОРЕЛИ.		
VO_BRM_027h_Oops_07	ОШИБКА!		
VO_BRM_027h_Sorry_10	ИЗВИНИ.		
VO_BRM_027h_Thanks_09	БЛАГОДАРЮ.		
VO_BRM_027h_Thinking1_12	ХМ...		
VO_BRM_027h_Thinking2_13	А ЕСЛИ...		
VO_BRM_027h_Thinking3_14	ЧТО БЫ СЖЕЧЬ...		
VO_BRM_027h_Threaten_08	ТЫ СГИНЕШЬ В ПЛАМЕНИ!		
VO_BRM_027h_Time_48	ТЫ ПРОЖИГАЕШЬ ВРЕМЯ.		
VO_BRM_027h_Well_Played_06	НЕПЛОХО.		
VO_BRM_027h_Winterveil_Greetings	ЗИМОЙ ДОЛЖНО БЫТЬ ТЕПЛЕЕ!		
VO_BRM_027h_WOW_20	ГОРЯЧО.		
VO_TBA01_4__Concede	*Рычит*		
VO_TBA01_4__Error_Full_Minions	*Рычит*		
VO_TBA01_4__Error_Generic	*Рычит*		
VO_TBA01_4__Error_Hand_Full	*Рычит*		
VO_TBA01_4__Error_I_Attacked	*Рычит*		
VO_TBA01_4__Error_Just_Played	*Рычит*		
VO_TBA01_4__Error_Minion_Attacked	*Рычит*		
VO_TBA01_4__Error_Need_Mana	*Рычит*		
VO_TBA01_4__Error_Need_Weapon	*Рычит*		
VO_TBA01_4__Error_Play	*Рычит*		
VO_TBA01_4__Error_Stealth	*Рычит*		
VO_TBA01_4__Good_Game	*Рычит*		
VO_TBA01_4__Greetings	Ну что ж, поиграем!		
VO_TBA01_4__Low_Cards	*Рычит*		
VO_TBA01_4__No_Cards	*Рычит*		
VO_TBA01_4__Oops	Ой.		
VO_TBA01_4__Sorry	Мне жаль.		
VO_TBA01_4__Start	Я здесь главный!		
VO_TBA01_4__Thanks	Спасибо.		
VO_TBA01_4__Threaten	Познай истинную силу Нефариана!		
VO_TBA01_4__Timer	*Рычит*		
VO_TBA01_4__Well_Played	Неплохо.		
