TAG	TEXT	COMMENT	AUDIOFILE
GAMEPLAY_EMOTE_EX1_323h_CONCEDE	お前の勝ちだ…だがやはりこの世界は滅亡するのだ！		
GAMEPLAY_EMOTE_EX1_323h_ERROR_FULL_MINIONS	ミニオンが多過ぎだ！！		
GAMEPLAY_EMOTE_EX1_323h_ERROR_GENERIC	できん！！		
GAMEPLAY_EMOTE_EX1_323h_ERROR_HAND_FULL	カードが多過ぎだ！！		
GAMEPLAY_EMOTE_EX1_323h_ERROR_I_ATTACKED	我は既に攻撃しておるわ！		
GAMEPLAY_EMOTE_EX1_323h_ERROR_JUST_PLAYED	アレはまだ動けぬわ！		
GAMEPLAY_EMOTE_EX1_323h_ERROR_MINION_ATTACKED	アレは既に攻撃しておるわ！		
GAMEPLAY_EMOTE_EX1_323h_ERROR_NEED_MANA	マナが足りん！		
GAMEPLAY_EMOTE_EX1_323h_ERROR_NEED_WEAPON	我の武器はどこに行った？！		
GAMEPLAY_EMOTE_EX1_323h_ERROR_PLAY	今そのカードは使えんのだ！		
GAMEPLAY_EMOTE_EX1_323h_ERROR_STEALTH	そやつは隠れ身しておる！		
GAMEPLAY_EMOTE_EX1_323h_ERROR_TARGET	そいつには使えん！！		
GAMEPLAY_EMOTE_EX1_323h_ERROR_TAUNT	挑発しているミニオンがおるだろうが！		
GAMEPLAY_EMOTE_EX1_323h_GOOD_GAME	よい勝負であった！		
GAMEPLAY_EMOTE_EX1_323h_GREETINGS	我こそジャラクサス、焦熱の軍団のエレダーロードなり！		
GAMEPLAY_EMOTE_EX1_323h_LOW_CARDS	我がデッキ！カードが尽きかけているだと？！		
GAMEPLAY_EMOTE_EX1_323h_LUNAR_NEW_YEAR	我こそジャラクサス、焦熱の軍団のエレダーロードなり！		
GAMEPLAY_EMOTE_EX1_323h_NO_CARDS	ぬぅぅっ！カードが尽きてしまったか！		
GAMEPLAY_EMOTE_EX1_323h_OOPS	しくじったか！！		
GAMEPLAY_EMOTE_EX1_323h_SORRY	このジャラクサス…すまん		
GAMEPLAY_EMOTE_EX1_323h_THANKS	礼を言うぞ。		
GAMEPLAY_EMOTE_EX1_323h_THINK1	うぬぬぬ…		
GAMEPLAY_EMOTE_EX1_323h_THINK2	どうするか…		
GAMEPLAY_EMOTE_EX1_323h_THINK3	どうやって滅ぼしてやろうか…		
GAMEPLAY_EMOTE_EX1_323h_THREATEN	滅びよ！！		
GAMEPLAY_EMOTE_EX1_323h_TIMER	時が尽きる！		
GAMEPLAY_EMOTE_EX1_323h_WELL_PLAYED	ふん、見事だ！		
GAMEPLAY_EMOTE_EX1_323h_WINTERVEIL_GREETINGS	冬至祭のメインディッシュはお前の魂だ！		
GAMEPLAY_EMOTE_EX1_323h_WOW_04	信じられん！		
GAMEPLAY_EMOTE_HERO_01_CONCEDE	オレは死を選ぶぞ！		
GAMEPLAY_EMOTE_HERO_01_ERROR_FULL_MINIONS	ミニオンが多過ぎる。		
GAMEPLAY_EMOTE_HERO_01_ERROR_GENERIC	それはできんぞ。		
GAMEPLAY_EMOTE_HERO_01_ERROR_HAND_FULL	手札が多過ぎる！		
GAMEPLAY_EMOTE_HERO_01_ERROR_I_ATTACKED	オレは攻撃した。		
GAMEPLAY_EMOTE_HERO_01_ERROR_JUST_PLAYED	そのミニオンが動けるのは次のターンからだ。		
GAMEPLAY_EMOTE_HERO_01_ERROR_MINION_ATTACKED	そのミニオンは攻撃済みだ。		
GAMEPLAY_EMOTE_HERO_01_ERROR_NEED_MANA	マナが足りん。		
GAMEPLAY_EMOTE_HERO_01_ERROR_NEED_WEAPON	武器が要る。		
GAMEPLAY_EMOTE_HERO_01_ERROR_PLAY	今そのカードは使えん。		
GAMEPLAY_EMOTE_HERO_01_ERROR_STEALTH	隠れ身しているミニオンは攻撃できん。		
GAMEPLAY_EMOTE_HERO_01_ERROR_TARGET	それは対象にできん。		
GAMEPLAY_EMOTE_HERO_01_ERROR_TAUNT	「挑発」を持つミニオンが邪魔だ。		
GAMEPLAY_EMOTE_HERO_01_EVENT_LUNAR_NEW_YEAR	ハッ、武運を！		
GAMEPLAY_EMOTE_HERO_01_GOOD_GAME	いい勝負だった！		
GAMEPLAY_EMOTE_HERO_01_GREETINGS	ハッ、武運を！		
GAMEPLAY_EMOTE_HERO_01_LOW_CARDS	カードが尽きる！		
GAMEPLAY_EMOTE_HERO_01_MIRROR_START	ガァッハッハッ！かかってこいィッ！		
GAMEPLAY_EMOTE_HERO_01_NO_CARDS	カードが尽きたぞ！		
GAMEPLAY_EMOTE_HERO_01_OOPS	しくじったな。		
GAMEPLAY_EMOTE_HERO_01_SORRY	悪く思うな。		
GAMEPLAY_EMOTE_HERO_01_START	勝利か、死かだ！		
GAMEPLAY_EMOTE_HERO_01_THANKS	礼を言うぞ。		
GAMEPLAY_EMOTE_HERO_01_THINK1	ヌゥゥ…		
GAMEPLAY_EMOTE_HERO_01_THINK2	どうしたものか…		
GAMEPLAY_EMOTE_HERO_01_THINK3	どいつをやるか…		
GAMEPLAY_EMOTE_HERO_01_THREATEN	叩き潰してやる！		
GAMEPLAY_EMOTE_HERO_01_TIMER	決断せねば！		
GAMEPLAY_EMOTE_HERO_01_WELL_PLAYED	見事だ。		
GAMEPLAY_EMOTE_HERO_01_WINTERVEIL_GREETINGS	冬至祭を祝うぞ！		
GAMEPLAY_EMOTE_HERO_01_WOW	見事だ！		
GAMEPLAY_EMOTE_HERO_01A_CONCEDE	おめぇの勝ちだぁ。		
GAMEPLAY_EMOTE_HERO_01A_ERROR_FULL_MINIONS	ミニオンが多過ぎるな。		
GAMEPLAY_EMOTE_HERO_01A_ERROR_GENERIC	それはできんのだ。		
GAMEPLAY_EMOTE_HERO_01A_ERROR_HAND_FULL	手札が多過ぎるわい！		
GAMEPLAY_EMOTE_HERO_01A_ERROR_I_ATTACKED	わしはもう攻撃したぞ。		
GAMEPLAY_EMOTE_HERO_01A_ERROR_JUST_PLAYED	そのミニオンが動けるのは次のターンからだ。		
GAMEPLAY_EMOTE_HERO_01A_ERROR_MINION_ATTACKED	そのミニオンは攻撃済みだな。		
GAMEPLAY_EMOTE_HERO_01A_ERROR_NEED_MANA	マナが足りん。		
GAMEPLAY_EMOTE_HERO_01A_ERROR_NEED_WEAPON	武器、わしの武器はどこだ。		
GAMEPLAY_EMOTE_HERO_01A_ERROR_PLAY	今そのカードは使えんぞ。		
GAMEPLAY_EMOTE_HERO_01A_ERROR_STEALTH	隠れ身しているミニオンは攻撃できんぞ。		
GAMEPLAY_EMOTE_HERO_01A_ERROR_TARGET	そいつは対象にできんな。		
GAMEPLAY_EMOTE_HERO_01A_ERROR_TAUNT	今攻撃できるのは「挑発」を持つミニオンだけだ。		
GAMEPLAY_EMOTE_HERO_01A_EVENT_LUNAR_NEW_YEAR	よおぉ。		
GAMEPLAY_EMOTE_HERO_01A_GOOD_GAME	よい勝負だったな。		
GAMEPLAY_EMOTE_HERO_01A_GREETINGS	よおぉ。		
GAMEPLAY_EMOTE_HERO_01A_LOW_CARDS	ぬぅ、カードが尽きるぞ！		
GAMEPLAY_EMOTE_HERO_01A_MIRROR_START	おう、カズモダンのために！		
GAMEPLAY_EMOTE_HERO_01A_NO_CARDS	くっ、カードが尽きたか！		
GAMEPLAY_EMOTE_HERO_01A_OOPS	ぬぅ…しくじったか。		
GAMEPLAY_EMOTE_HERO_01A_SORRY	わりぃな、アンタ。		
GAMEPLAY_EMOTE_HERO_01A_START	カズモダンのために！		
GAMEPLAY_EMOTE_HERO_01A_THANKS	ありがとうよ！		
GAMEPLAY_EMOTE_HERO_01A_THINK1	うむむむ…		
GAMEPLAY_EMOTE_HERO_01A_THINK2	この手は…いや違うか…		
GAMEPLAY_EMOTE_HERO_01A_THINK3	どの手を打つか…		
GAMEPLAY_EMOTE_HERO_01A_THREATEN	山の怒りを知るがいい！		
GAMEPLAY_EMOTE_HERO_01A_TIMER	もだもだしてらんね！		
GAMEPLAY_EMOTE_HERO_01A_WELL_PLAYED	見事だ。		
GAMEPLAY_EMOTE_HERO_01A_WINTERVEIL_GREETINGS	冬至祭おめでとう！		
GAMEPLAY_EMOTE_HERO_01A_WOW	我が髭に賭けて！		
GAMEPLAY_EMOTE_HERO_02_CONCEDE	これはお主の勝ちだな、友よ。		
GAMEPLAY_EMOTE_HERO_02_ERROR_FULL_MINIONS	ミニオンが多過ぎるな。		
GAMEPLAY_EMOTE_HERO_02_ERROR_GENERIC	それは無理だな。		
GAMEPLAY_EMOTE_HERO_02_ERROR_HAND_FULL	手札が多過ぎる！		
GAMEPLAY_EMOTE_HERO_02_ERROR_I_ATTACKED	私はもう攻撃済みだ。		
GAMEPLAY_EMOTE_HERO_02_ERROR_JUST_PLAYED	そのミニオンが動けるのは次のターンからだな。		
GAMEPLAY_EMOTE_HERO_02_ERROR_MINION_ATTACKED	そのミニオンは攻撃済みだな。		
GAMEPLAY_EMOTE_HERO_02_ERROR_NEED_MANA	マナが足りんな。		
GAMEPLAY_EMOTE_HERO_02_ERROR_NEED_WEAPON	武器が要るな。		
GAMEPLAY_EMOTE_HERO_02_ERROR_PLAY	今そのカードは使えんな。		
GAMEPLAY_EMOTE_HERO_02_ERROR_STEALTH	隠れ身してるミニオンは攻撃できんな。		
GAMEPLAY_EMOTE_HERO_02_ERROR_TARGET	それは対象にできんな。		
GAMEPLAY_EMOTE_HERO_02_ERROR_TAUNT	「挑発」を持つミニオンが、待ち受けている。		
GAMEPLAY_EMOTE_HERO_02_EVENT_LUNAR_NEW_YEAR	よろしく、我が友よ！		
GAMEPLAY_EMOTE_HERO_02_GOOD_GAME	よい勝負だった！		
GAMEPLAY_EMOTE_HERO_02_GREETINGS	よろしく、我が友よ！		
GAMEPLAY_EMOTE_HERO_02_LOW_CARDS	カードが尽きるぞ！		
GAMEPLAY_EMOTE_HERO_02_MIRROR_START	フロストウルフに捧ぐ！		
GAMEPLAY_EMOTE_HERO_02_NO_CARDS	カードが尽きたか！		
GAMEPLAY_EMOTE_HERO_02_OOPS	ぬかったか。		
GAMEPLAY_EMOTE_HERO_02_SORRY	すまんな。		
GAMEPLAY_EMOTE_HERO_02_START	ドゥームハンマーに捧ぐ！		
GAMEPLAY_EMOTE_HERO_02_THANKS	ありがたい。		
GAMEPLAY_EMOTE_HERO_02_THINK1	ふむぅ…		
GAMEPLAY_EMOTE_HERO_02_THINK2	はてさて…		
GAMEPLAY_EMOTE_HERO_02_THINK3	ふむぅ…どうするか…		
GAMEPLAY_EMOTE_HERO_02_THREATEN	精霊がお主を討つ！		
GAMEPLAY_EMOTE_HERO_02_TIMER	時間がない！		
GAMEPLAY_EMOTE_HERO_02_WELL_PLAYED	お見事。		
GAMEPLAY_EMOTE_HERO_02_WINTERVEIL_GREETINGS	冬至祭を祝おう！		
GAMEPLAY_EMOTE_HERO_02_WOW	見事な一手だ！		
GAMEPLAY_EMOTE_HERO_03_CONCEDE	降参よ。		
GAMEPLAY_EMOTE_HERO_03_ERROR_FULL_MINIONS	ミニオンが多過ぎるわね。		
GAMEPLAY_EMOTE_HERO_03_ERROR_GENERIC	それは無理。		
GAMEPLAY_EMOTE_HERO_03_ERROR_HAND_FULL	手札が多過ぎるわ！		
GAMEPLAY_EMOTE_HERO_03_ERROR_I_ATTACKED	あたしはもう攻撃したわ。		
GAMEPLAY_EMOTE_HERO_03_ERROR_JUST_PLAYED	そのミニオンが動けるのは次のターンからね。		
GAMEPLAY_EMOTE_HERO_03_ERROR_MINION_ATTACKED	そのミニオンは攻撃済みよ。		
GAMEPLAY_EMOTE_HERO_03_ERROR_NEED_MANA	マナが足りないわ。		
GAMEPLAY_EMOTE_HERO_03_ERROR_NEED_WEAPON	武器が要るわね。		
GAMEPLAY_EMOTE_HERO_03_ERROR_PLAY	今そのカードは使えないわね。		
GAMEPLAY_EMOTE_HERO_03_ERROR_STEALTH	隠れ身してるミニオンは攻撃できないわ。		
GAMEPLAY_EMOTE_HERO_03_ERROR_TARGET	それは対象にできないわ。		
GAMEPLAY_EMOTE_HERO_03_ERROR_TAUNT	「挑発」を持つミニオンが邪魔。		
GAMEPLAY_EMOTE_HERO_03_EVENT_LUNAR_NEW_YEAR	お付き合い願うわ。		
GAMEPLAY_EMOTE_HERO_03_GOOD_GAME	いい勝負だったわ！		
GAMEPLAY_EMOTE_HERO_03_GREETINGS	お付き合い願うわ。		
GAMEPLAY_EMOTE_HERO_03_LOW_CARDS	カードが無くなるわ！		
GAMEPLAY_EMOTE_HERO_03_MIRROR_START	よそ見は、禁物よ。		
GAMEPLAY_EMOTE_HERO_03_NO_CARDS	カードが無くなったわ！		
GAMEPLAY_EMOTE_HERO_03_OOPS	しくじったわね…		
GAMEPLAY_EMOTE_HERO_03_SORRY	悪いわね。		
GAMEPLAY_EMOTE_HERO_03_START	背中に気をつけて。		
GAMEPLAY_EMOTE_HERO_03_THANKS	ありがとう。		
GAMEPLAY_EMOTE_HERO_03_THINK1	うぅん…		
GAMEPLAY_EMOTE_HERO_03_THINK2	この手なら…		
GAMEPLAY_EMOTE_HERO_03_THINK3	どの手で行くか…		
GAMEPLAY_EMOTE_HERO_03_THREATEN	あなたの死神よ！		
GAMEPLAY_EMOTE_HERO_03_TIMER	早く決めなきゃ！		
GAMEPLAY_EMOTE_HERO_03_WELL_PLAYED	お見事ね。		
GAMEPLAY_EMOTE_HERO_03_WINTERVEIL_GREETINGS	冬至祭、おめでとう。		
GAMEPLAY_EMOTE_HERO_03_WOW	やるわね。		
GAMEPLAY_EMOTE_HERO_04_CONCEDE	貴公の勝ちだ。		
GAMEPLAY_EMOTE_HERO_04_ERROR_FULL_MINIONS	ミニオンが多過ぎですな。		
GAMEPLAY_EMOTE_HERO_04_ERROR_GENERIC	それは無理ですな。		
GAMEPLAY_EMOTE_HERO_04_ERROR_HAND_FULL	手札が多過ぎますぞ！		
GAMEPLAY_EMOTE_HERO_04_ERROR_I_ATTACKED	ワシはもう攻撃しましたぞ。		
GAMEPLAY_EMOTE_HERO_04_ERROR_JUST_PLAYED	そのミニオンが動けるのは次のターンからですぞ。		
GAMEPLAY_EMOTE_HERO_04_ERROR_MINION_ATTACKED	そのミニオンは攻撃済みですぞ。		
GAMEPLAY_EMOTE_HERO_04_ERROR_NEED_MANA	マナが足りませんな。		
GAMEPLAY_EMOTE_HERO_04_ERROR_NEED_WEAPON	武器が必要ですな。		
GAMEPLAY_EMOTE_HERO_04_ERROR_PLAY	今そのカードは使えませんな。		
GAMEPLAY_EMOTE_HERO_04_ERROR_STEALTH	隠れ身しているミニオンは攻撃できませんぞ。		
GAMEPLAY_EMOTE_HERO_04_ERROR_TARGET	それは対象にできませんぞ。		
GAMEPLAY_EMOTE_HERO_04_ERROR_TAUNT	「挑発」を持つミニオンが邪魔だな。		
GAMEPLAY_EMOTE_HERO_04_EVENT_LUNAR_NEW_YEAR	ご挨拶仕る！		
GAMEPLAY_EMOTE_HERO_04_GOOD_GAME	よい勝負でしたな！		
GAMEPLAY_EMOTE_HERO_04_GREETINGS	ご挨拶仕る！		
GAMEPLAY_EMOTE_HERO_04_LOW_CARDS	まもなくカードが尽きる！		
GAMEPLAY_EMOTE_HERO_04_MIRROR_START	我、光を導かん。		
GAMEPLAY_EMOTE_HERO_04_NO_CARDS	カードが尽きたか！		
GAMEPLAY_EMOTE_HERO_04_OOPS	しくじりましたな。		
GAMEPLAY_EMOTE_HERO_04_SORRY	失礼した。		
GAMEPLAY_EMOTE_HERO_04_START	我、名誉を以て戦う！		
GAMEPLAY_EMOTE_HERO_04_THANKS	感謝いたす。		
GAMEPLAY_EMOTE_HERO_04_THINK1	ふむむむ…		
GAMEPLAY_EMOTE_HERO_04_THINK2	はて…		
GAMEPLAY_EMOTE_HERO_04_THINK3	考える時間をくだされ…		
GAMEPLAY_EMOTE_HERO_04_THREATEN	正義の報復を受けよ！		
GAMEPLAY_EMOTE_HERO_04_TIMER	急がなければ！		
GAMEPLAY_EMOTE_HERO_04_WELL_PLAYED	お見事。		
GAMEPLAY_EMOTE_HERO_04_WINTERVEIL_GREETINGS	勇者よ、冬至祭を祝いましょうぞ！		
GAMEPLAY_EMOTE_HERO_04_WOW	これは仰天した！		
GAMEPLAY_EMOTE_HERO_04A_CONCEDE	貴方の勝ちだ。降伏する。		
GAMEPLAY_EMOTE_HERO_04A_ERROR_FULL_MINIONS	これ以上のミニオンは指揮を乱す。		
GAMEPLAY_EMOTE_HERO_04A_ERROR_GENERIC	それはできぬ。		
GAMEPLAY_EMOTE_HERO_04A_ERROR_HAND_FULL	手札が多過ぎる！		
GAMEPLAY_EMOTE_HERO_04A_ERROR_I_ATTACKED	私は既に攻撃を終えた。		
GAMEPLAY_EMOTE_HERO_04A_ERROR_JUST_PLAYED	そのミニオンは次のターンを待たねばならぬ。		
GAMEPLAY_EMOTE_HERO_04A_ERROR_MINION_ATTACKED	そのミニオンは既に攻撃を終えた。		
GAMEPLAY_EMOTE_HERO_04A_ERROR_NEED_MANA	マナが足りないわね。		
GAMEPLAY_EMOTE_HERO_04A_ERROR_NEED_WEAPON	武器が必要だわ。		
GAMEPLAY_EMOTE_HERO_04A_ERROR_PLAY	今その手は打てぬ。		
GAMEPLAY_EMOTE_HERO_04A_ERROR_STEALTH	隠れ身しているミニオンは攻められぬ。		
GAMEPLAY_EMOTE_HERO_04A_ERROR_TARGET	それは対象にできぬ。		
GAMEPLAY_EMOTE_HERO_04A_ERROR_TAUNT	「挑発」を持つミニオンを攻撃せねばならぬ。		
GAMEPLAY_EMOTE_HERO_04A_GOOD_GAME	よい勝負でした！		
GAMEPLAY_EMOTE_HERO_04A_GREETINGS	挑む者よ、健闘を。		
GAMEPLAY_EMOTE_HERO_04A_LOW_CARDS	くっ、カードが尽きる！		
GAMEPLAY_EMOTE_HERO_04A_LUNAR_NEW_YEAR	挑む者よ、健闘を。		
GAMEPLAY_EMOTE_HERO_04A_MIRROR_START	奇遇ね、「聖なる炎」は私の二つ名よ。		
GAMEPLAY_EMOTE_HERO_04A_NO_CARDS	カードが尽きてしまった…！		
GAMEPLAY_EMOTE_HERO_04A_OOPS	失策ね、間違いなく。		
GAMEPLAY_EMOTE_HERO_04A_SORRY	あら、失礼。		
GAMEPLAY_EMOTE_HERO_04A_START	我が槌は、聖なる炎を宿す！		
GAMEPLAY_EMOTE_HERO_04A_THANKS	心からの感謝を。		
GAMEPLAY_EMOTE_HERO_04A_THINK1	うぅん…。		
GAMEPLAY_EMOTE_HERO_04A_THINK2	最善の手は…。		
GAMEPLAY_EMOTE_HERO_04A_THINK3	やはりここは…うぅん…。		
GAMEPLAY_EMOTE_HERO_04A_THREATEN	外道め、報いを受けよ！		
GAMEPLAY_EMOTE_HERO_04A_TIMER	いざ、進軍！		
GAMEPLAY_EMOTE_HERO_04A_WELL_PLAYED	お見事。		
GAMEPLAY_EMOTE_HERO_04A_WINTERVEIL_GREETINGS	冬至祭を祝うぞ！		
GAMEPLAY_EMOTE_HERO_04A_WOW	感服しました！		
GAMEPLAY_EMOTE_HERO_05_CONCEDE	見事な戦いぶりだった。俺の負けだ。		
GAMEPLAY_EMOTE_HERO_05_ERROR_FULL_MINIONS	ミニオンが多過ぎるか。		
GAMEPLAY_EMOTE_HERO_05_ERROR_GENERIC	それはできん。		
GAMEPLAY_EMOTE_HERO_05_ERROR_HAND_FULL	手札が多過ぎる！		
GAMEPLAY_EMOTE_HERO_05_ERROR_I_ATTACKED	俺は攻撃済みだ。		
GAMEPLAY_EMOTE_HERO_05_ERROR_JUST_PLAYED	そのミニオンが動けるのは次のターンからだ。		
GAMEPLAY_EMOTE_HERO_05_ERROR_MINION_ATTACKED	そのミニオンは攻撃済みだ。		
GAMEPLAY_EMOTE_HERO_05_ERROR_NEED_MANA	マナが足りん。		
GAMEPLAY_EMOTE_HERO_05_ERROR_NEED_WEAPON	武器が要る。		
GAMEPLAY_EMOTE_HERO_05_ERROR_PLAY	今そのカードは使えん。		
GAMEPLAY_EMOTE_HERO_05_ERROR_STEALTH	隠れ身しているミニオンは攻撃できん。		
GAMEPLAY_EMOTE_HERO_05_ERROR_TARGET	それは対象にできん。		
GAMEPLAY_EMOTE_HERO_05_ERROR_TAUNT	「挑発」を持つミニオンが邪魔だ。		
GAMEPLAY_EMOTE_HERO_05_EVENT_LUNAR_NEW_YEAR	敬意を、旅人よ。		
GAMEPLAY_EMOTE_HERO_05_GOOD_GAME	よい狩りだった。		
GAMEPLAY_EMOTE_HERO_05_GREETINGS	敬意を、旅人よ。		
GAMEPLAY_EMOTE_HERO_05_LOW_CARDS	カードが尽きる！		
GAMEPLAY_EMOTE_HERO_05_MIRROR_START	かかって来い！		
GAMEPLAY_EMOTE_HERO_05_NO_CARDS	カードが尽きたか！		
GAMEPLAY_EMOTE_HERO_05_OOPS	的外れもいいところだ。		
GAMEPLAY_EMOTE_HERO_05_SORRY	失敬。		
GAMEPLAY_EMOTE_HERO_05_START	狩りの時間だ！		
GAMEPLAY_EMOTE_HERO_05_THANKS	感謝。		
GAMEPLAY_EMOTE_HERO_05_THINK1	むむ…		
GAMEPLAY_EMOTE_HERO_05_THINK2	どう仕掛けるか…		
GAMEPLAY_EMOTE_HERO_05_THINK3	ふむむむ…		
GAMEPLAY_EMOTE_HERO_05_THREATEN	お前を狩る！		
GAMEPLAY_EMOTE_HERO_05_TIMER	好機を逃すぞ！		
GAMEPLAY_EMOTE_HERO_05_WELL_PLAYED	見事だ。		
GAMEPLAY_EMOTE_HERO_05_WINTERVEIL_GREETINGS	冬至祭の祝いを！		
GAMEPLAY_EMOTE_HERO_05_WOW	見事な！		
GAMEPLAY_EMOTE_HERO_05A_CONCEDE	お見事。あたしの負けね。		
GAMEPLAY_EMOTE_HERO_05A_ERROR_FULL_MINIONS	ミニオンが多過ぎるわね。		
GAMEPLAY_EMOTE_HERO_05A_ERROR_GENERIC	それは無理よ。		
GAMEPLAY_EMOTE_HERO_05A_ERROR_HAND_FULL	手札が多過ぎるわ！		
GAMEPLAY_EMOTE_HERO_05A_ERROR_I_ATTACKED	あたしはもう攻撃したわ。		
GAMEPLAY_EMOTE_HERO_05A_ERROR_JUST_PLAYED	そのミニオンが動けるのは次のターンからよ。		
GAMEPLAY_EMOTE_HERO_05A_ERROR_MINION_ATTACKED	そのミニオンは攻撃済みね。		
GAMEPLAY_EMOTE_HERO_05A_ERROR_NEED_MANA	マナが足りないわ。		
GAMEPLAY_EMOTE_HERO_05A_ERROR_NEED_WEAPON	武器が必要よ。		
GAMEPLAY_EMOTE_HERO_05A_ERROR_PLAY	それはできないわよ。		
GAMEPLAY_EMOTE_HERO_05A_ERROR_STEALTH	隠れ身しているミニオンは狙えないわ。		
GAMEPLAY_EMOTE_HERO_05A_ERROR_TARGET	それは標的にできないわ。		
GAMEPLAY_EMOTE_HERO_05A_ERROR_TAUNT	今狙えるのは「挑発」を持つミニオンだけよ。		
GAMEPLAY_EMOTE_HERO_05A_EVENT_LUNAR_NEW_YEAR	ようこそ、旅人さん。		
GAMEPLAY_EMOTE_HERO_05A_GOOD_GAME	いい勝負だったわ。		
GAMEPLAY_EMOTE_HERO_05A_GREETINGS	ようこそ、旅人さん。		
GAMEPLAY_EMOTE_HERO_05A_LOW_CARDS	カードが尽きる…！		
GAMEPLAY_EMOTE_HERO_05A_MIRROR_START	震えるのは、どちらかしらね。		
GAMEPLAY_EMOTE_HERO_05A_NO_CARDS	カードが尽きたわ！		
GAMEPLAY_EMOTE_HERO_05A_OOPS	間違いね。		
GAMEPLAY_EMOTE_HERO_05A_SORRY	悪いわね。		
GAMEPLAY_EMOTE_HERO_05A_START	エルフ族の力の前に、震えるがいいわ！		
GAMEPLAY_EMOTE_HERO_05A_THANKS	どうも。		
GAMEPLAY_EMOTE_HERO_05A_THINK1	う～ん…		
GAMEPLAY_EMOTE_HERO_05A_THINK2	どいつを射る…		
GAMEPLAY_EMOTE_HERO_05A_THINK3	どうする…		
GAMEPLAY_EMOTE_HERO_05A_THREATEN	覚悟はいいわね？！		
GAMEPLAY_EMOTE_HERO_05A_TIMER	今よ。かかれ！		
GAMEPLAY_EMOTE_HERO_05A_WELL_PLAYED	見事ね。		
GAMEPLAY_EMOTE_HERO_05A_WINTERVEIL_GREETING	冬至祭おめでとう。		
GAMEPLAY_EMOTE_HERO_05A_WOW	すごいわ！		
GAMEPLAY_EMOTE_HERO_06_CONCEDE	敗北を認めよう。		
GAMEPLAY_EMOTE_HERO_06_ERROR_FULL_MINIONS	ミニオンが多過ぎるか。		
GAMEPLAY_EMOTE_HERO_06_ERROR_GENERIC	それはできぬ。		
GAMEPLAY_EMOTE_HERO_06_ERROR_HAND_FULL	手札が多過ぎる！		
GAMEPLAY_EMOTE_HERO_06_ERROR_I_ATTACKED	私は攻撃済みだ。		
GAMEPLAY_EMOTE_HERO_06_ERROR_JUST_PLAYED	そのミニオンが動けるのは次のターンからだ。		
GAMEPLAY_EMOTE_HERO_06_ERROR_MINION_ATTACKED	そのミニオンは攻撃済みだ。		
GAMEPLAY_EMOTE_HERO_06_ERROR_NEED_MANA	マナが足りぬか。		
GAMEPLAY_EMOTE_HERO_06_ERROR_NEED_WEAPON	武器が必要だ。		
GAMEPLAY_EMOTE_HERO_06_ERROR_PLAY	今そのカードは使えぬぞ。		
GAMEPLAY_EMOTE_HERO_06_ERROR_STEALTH	隠れ身しているミニオンは攻撃できぬ。		
GAMEPLAY_EMOTE_HERO_06_ERROR_TARGET	それは対象にできぬな。		
GAMEPLAY_EMOTE_HERO_06_ERROR_TAUNT	「挑発」を持つミニオンが邪魔だ。		
GAMEPLAY_EMOTE_HERO_06_EVENT_LUNAR_NEW_YEAR	お主に敬意を。		
GAMEPLAY_EMOTE_HERO_06_GOOD_GAME	よい勝負であった。		
GAMEPLAY_EMOTE_HERO_06_GREETINGS	お主に敬意を。		
GAMEPLAY_EMOTE_HERO_06_LOW_CARDS	カードが尽きてしまう！		
GAMEPLAY_EMOTE_HERO_06_MIRROR_START	いたずらに自然に触れてはならぬ！		
GAMEPLAY_EMOTE_HERO_06_NO_CARDS	カードが尽きてしまった！		
GAMEPLAY_EMOTE_HERO_06_OOPS	油断したか…		
GAMEPLAY_EMOTE_HERO_06_SORRY	申し訳ない。		
GAMEPLAY_EMOTE_HERO_06_START	自然を守らねばならぬ！		
GAMEPLAY_EMOTE_HERO_06_THANKS	感謝つかまつる。		
GAMEPLAY_EMOTE_HERO_06_THINK1	フム…		
GAMEPLAY_EMOTE_HERO_06_THINK2	フム…さて…		
GAMEPLAY_EMOTE_HERO_06_THINK3	どうしたものか…		
GAMEPLAY_EMOTE_HERO_06_THREATEN	自然の怒りを知るがよい！		
GAMEPLAY_EMOTE_HERO_06_TIMER	時は無情！		
GAMEPLAY_EMOTE_HERO_06_WELL_PLAYED	ふむ、見事。		
GAMEPLAY_EMOTE_HERO_06_WINTERVEIL_GREETINGS	冬至祭を祝おう！		
GAMEPLAY_EMOTE_HERO_06_WOW	なんと素晴らしい！		
GAMEPLAY_EMOTE_HERO_07_CONCEDE	今回はお前の勝ちだ…		
GAMEPLAY_EMOTE_HERO_07_ERROR_FULL_MINIONS	ミニオンが多過ぎる。		
GAMEPLAY_EMOTE_HERO_07_ERROR_GENERIC	それはできん。		
GAMEPLAY_EMOTE_HERO_07_ERROR_HAND_FULL	手札が多過ぎる！		
GAMEPLAY_EMOTE_HERO_07_ERROR_I_ATTACKED	我はもう攻撃している。		
GAMEPLAY_EMOTE_HERO_07_ERROR_JUST_PLAYED	そのミニオンが動けるのは次のターンからだ。		
GAMEPLAY_EMOTE_HERO_07_ERROR_MINION_ATTACKED	そのミニオンは攻撃済みだ。		
GAMEPLAY_EMOTE_HERO_07_ERROR_NEED_MANA	マナが足りんな。		
GAMEPLAY_EMOTE_HERO_07_ERROR_NEED_WEAPON	武器が必要だ。		
GAMEPLAY_EMOTE_HERO_07_ERROR_PLAY	今そのカードは使えんな。		
GAMEPLAY_EMOTE_HERO_07_ERROR_STEALTH	隠れ身しているミニオンは攻撃できんな。		
GAMEPLAY_EMOTE_HERO_07_ERROR_TARGET	それは対象にできんな。		
GAMEPLAY_EMOTE_HERO_07_ERROR_TAUNT	「挑発」を持つミニオンが邪魔だ。		
GAMEPLAY_EMOTE_HERO_07_EVENT_LUNAR_NEW_YEAR	御機嫌よう。		
GAMEPLAY_EMOTE_HERO_07_GOOD_GAME	よい勝負であった。		
GAMEPLAY_EMOTE_HERO_07_GREETINGS	御機嫌よう。		
GAMEPLAY_EMOTE_HERO_07_LOW_CARDS	もうすぐカードが尽きるぞ！		
GAMEPLAY_EMOTE_HERO_07_MIRROR_START	我はお前の悪夢となろう！		
GAMEPLAY_EMOTE_HERO_07_NO_CARDS	カードが尽きたか！		
GAMEPLAY_EMOTE_HERO_07_OOPS	失策であった。		
GAMEPLAY_EMOTE_HERO_07_SORRY	失敬。		
GAMEPLAY_EMOTE_HERO_07_START	お前の魂は我が物となろう！		
GAMEPLAY_EMOTE_HERO_07_THANKS	感謝する。		
GAMEPLAY_EMOTE_HERO_07_THINK1	ふ～む…		
GAMEPLAY_EMOTE_HERO_07_THINK2	どうする…		
GAMEPLAY_EMOTE_HERO_07_THINK3	どの手を打つべきか…		
GAMEPLAY_EMOTE_HERO_07_THREATEN	お前の魂に苦痛あれ！		
GAMEPLAY_EMOTE_HERO_07_TIMER	時間が尽きるぞ！		
GAMEPLAY_EMOTE_HERO_07_WELL_PLAYED	見事。		
GAMEPLAY_EMOTE_HERO_07_WINTERVEIL_GREETINGS	喜ばしき冬至祭よ…		
GAMEPLAY_EMOTE_HERO_07_WOW	桁外れな。		
GAMEPLAY_EMOTE_HERO_08_CONCEDE	今回は貴方の勝ちね。		
GAMEPLAY_EMOTE_HERO_08_ERROR_FULL_MINIONS	ミニオンが多過ぎるわ。		
GAMEPLAY_EMOTE_HERO_08_ERROR_GENERIC	それはできないわ。		
GAMEPLAY_EMOTE_HERO_08_ERROR_HAND_FULL	手札が多過ぎるわ！		
GAMEPLAY_EMOTE_HERO_08_ERROR_I_ATTACKED	私はもう攻撃したわ。		
GAMEPLAY_EMOTE_HERO_08_ERROR_JUST_PLAYED	そのミニオンは次のターンから動けるわ。		
GAMEPLAY_EMOTE_HERO_08_ERROR_MINION_ATTACKED	そのミニオンは攻撃済みね。		
GAMEPLAY_EMOTE_HERO_08_ERROR_NEED_MANA	マナが足りないわ。		
GAMEPLAY_EMOTE_HERO_08_ERROR_NEED_WEAPON	武器が必要だわ。		
GAMEPLAY_EMOTE_HERO_08_ERROR_PLAY	今そのカードは使えないわ。		
GAMEPLAY_EMOTE_HERO_08_ERROR_STEALTH	隠れ身しているミニオンは攻撃できないわ。		
GAMEPLAY_EMOTE_HERO_08_ERROR_TARGET	それは対象にできないわ。		
GAMEPLAY_EMOTE_HERO_08_ERROR_TAUNT	「挑発」を持つミニオンが邪魔ね。		
GAMEPLAY_EMOTE_HERO_08_EVENT_LUNAR_NEW_YEAR	ご機嫌いかが。		
GAMEPLAY_EMOTE_HERO_08_GOOD_GAME	いい勝負だったわ。		
GAMEPLAY_EMOTE_HERO_08_GREETINGS	ご機嫌いかが。		
GAMEPLAY_EMOTE_HERO_08_LOW_CARDS	もうほとんどカードが無いわ！		
GAMEPLAY_EMOTE_HERO_08_MIRROR_START	それはこっちのセリフよ！		
GAMEPLAY_EMOTE_HERO_08_NO_CARDS	カードが無くなったわ！		
GAMEPLAY_EMOTE_HERO_08_OOPS	おおっと。		
GAMEPLAY_EMOTE_HERO_08_SORRY	失礼。		
GAMEPLAY_EMOTE_HERO_08_START	貴方が招いたのよ。		
GAMEPLAY_EMOTE_HERO_08_THANKS	感謝を。		
GAMEPLAY_EMOTE_HERO_08_THINK1	ふ～む…		
GAMEPLAY_EMOTE_HERO_08_THINK2	どうかしら…		
GAMEPLAY_EMOTE_HERO_08_THINK3	この手…それとも、この手…		
GAMEPLAY_EMOTE_HERO_08_THREATEN	私の魔法で引き裂かれるがいいわ！		
GAMEPLAY_EMOTE_HERO_08_TIMER	あまり時間がないわ！		
GAMEPLAY_EMOTE_HERO_08_WELL_PLAYED	お見事。		
GAMEPLAY_EMOTE_HERO_08_WINTERVEIL_GREETINGS	冬至祭を祝いましょう！		
GAMEPLAY_EMOTE_HERO_08_WOW	すごいわ。		
GAMEPLAY_EMOTE_HERO_08A_CONCEDE	これも我が罪、我の詰みか。お見事。		
GAMEPLAY_EMOTE_HERO_08A_ERROR_FULL_MINIONS	手駒が多過ぎるか。		
GAMEPLAY_EMOTE_HERO_08A_ERROR_GENERIC	それは不可能だ。		
GAMEPLAY_EMOTE_HERO_08A_ERROR_HAND_FULL	手札が多過ぎたか！		
GAMEPLAY_EMOTE_HERO_08A_ERROR_I_ATTACKED	私自らの一撃、既に為された。		
GAMEPLAY_EMOTE_HERO_08A_ERROR_JUST_PLAYED	その駒が動けるのは次の手番からだ。		
GAMEPLAY_EMOTE_HERO_08A_ERROR_MINION_ATTACKED	その駒は既に動いている。		
GAMEPLAY_EMOTE_HERO_08A_ERROR_NEED_MANA	マナが足りない。		
GAMEPLAY_EMOTE_HERO_08A_ERROR_NEED_WEAPON	武器が必要だ。		
GAMEPLAY_EMOTE_HERO_08A_ERROR_PLAY	今その手は打てない。		
GAMEPLAY_EMOTE_HERO_08A_ERROR_STEALTH	隠れ身している駒は取れない。		
GAMEPLAY_EMOTE_HERO_08A_ERROR_TARGET	それは対象にできない。		
GAMEPLAY_EMOTE_HERO_08A_ERROR_TAUNT	「挑発」を持つ駒を除くのが先決だ。		
GAMEPLAY_EMOTE_HERO_08A_GOOD_GAME	よい対局だった。		
GAMEPLAY_EMOTE_HERO_08A_GREETINGS	ああ。御機嫌よう。		
GAMEPLAY_EMOTE_HERO_08A_LOW_CARDS	む、カードが尽きる！		
GAMEPLAY_EMOTE_HERO_08A_LUNAR_NEW_YEAR	ああ。御機嫌よう。		
GAMEPLAY_EMOTE_HERO_08A_MIRROR_START	否、既に動いているとも。		
GAMEPLAY_EMOTE_HERO_08A_NO_CARDS	カードが尽きたか！		
GAMEPLAY_EMOTE_HERO_08A_OOPS	愚の骨頂。		
GAMEPLAY_EMOTE_HERO_08A_SORRY	心からお詫び申し上げる。		
GAMEPLAY_EMOTE_HERO_08A_START	いざ、駒を進めるとしよう。		
GAMEPLAY_EMOTE_HERO_08A_THANKS	感謝する。		
GAMEPLAY_EMOTE_HERO_08A_THINK1	ふむぅ…		
GAMEPLAY_EMOTE_HERO_08A_THINK2	これは面白い…		
GAMEPLAY_EMOTE_HERO_08A_THINK3	あるいは…		
GAMEPLAY_EMOTE_HERO_08A_THREATEN	何物も私を止められぬ。何物も！		
GAMEPLAY_EMOTE_HERO_08A_TIMER	悠長にしている場合ではない！		
GAMEPLAY_EMOTE_HERO_08A_WELL_PLAYED	見事だ。		
GAMEPLAY_EMOTE_HERO_08A_WINTERVEIL_GREETINGS	挑戦者よ、冬至祭の慶びを。		
GAMEPLAY_EMOTE_HERO_08A_WOW	まさに妙手。		
GAMEPLAY_EMOTE_HERO_08B_CONCEDE	お見事。君の勝ちだ。		
GAMEPLAY_EMOTE_HERO_08B_ERROR_FULL_MINIONS	ミニオンが多過ぎるか。		
GAMEPLAY_EMOTE_HERO_08B_ERROR_GENERIC	それはできないな。		
GAMEPLAY_EMOTE_HERO_08B_ERROR_HAND_FULL	手札が多過ぎる！		
GAMEPLAY_EMOTE_HERO_08B_ERROR_I_ATTACKED	もう攻撃したぞ。		
GAMEPLAY_EMOTE_HERO_08B_ERROR_JUST_PLAYED	そのミニオンは次のターンから動ける。		
GAMEPLAY_EMOTE_HERO_08B_ERROR_MINION_ATTACKED	そのミニオンは攻撃済みだな。		
GAMEPLAY_EMOTE_HERO_08B_ERROR_NEED_MANA	マナが足りないな。		
GAMEPLAY_EMOTE_HERO_08B_ERROR_NEED_WEAPON	武器がいるな。		
GAMEPLAY_EMOTE_HERO_08B_ERROR_PLAY	今その手は打てない。		
GAMEPLAY_EMOTE_HERO_08B_ERROR_STEALTH	隠れ身しているミニオンは攻められん。		
GAMEPLAY_EMOTE_HERO_08B_ERROR_TARGET	それは対象にできないな。		
GAMEPLAY_EMOTE_HERO_08B_ERROR_TAUNT	「挑発」を持つミニオンが邪魔だ。		
GAMEPLAY_EMOTE_HERO_08B_GOOD_GAME	はてさて。よい勝負だったな！		
GAMEPLAY_EMOTE_HERO_08B_GREETINGS	よろしく、真理の探究者よ。		
GAMEPLAY_EMOTE_HERO_08B_LOW_CARDS	カードが尽きるか。		
GAMEPLAY_EMOTE_HERO_08B_LUNAR_NEW_YEAR	よろしく、真理の探究者よ。		
GAMEPLAY_EMOTE_HERO_08B_MIRROR_START	我ら、共に多くを学ばん。		
GAMEPLAY_EMOTE_HERO_08B_NO_CARDS	カードが尽きたか！		
GAMEPLAY_EMOTE_HERO_08B_OOPS	なんと。やれやれ。		
GAMEPLAY_EMOTE_HERO_08B_SORRY	なんともはや。すまないね。		
GAMEPLAY_EMOTE_HERO_08B_START	知は力なり。		
GAMEPLAY_EMOTE_HERO_08B_THANKS	友よ、感謝する。		
GAMEPLAY_EMOTE_HERO_08B_THINK1	う～ん…		
GAMEPLAY_EMOTE_HERO_08B_THINK2	観察し、省察し…		
GAMEPLAY_EMOTE_HERO_08B_THINK3	必ず、打つ手が…		
GAMEPLAY_EMOTE_HERO_08B_THREATEN	猪口才な若造め、教育してくれる！		
GAMEPLAY_EMOTE_HERO_08B_TIMER	こんな時間か！		
GAMEPLAY_EMOTE_HERO_08B_WELL_PLAYED	お見事。		
GAMEPLAY_EMOTE_HERO_08B_WINTERVEIL_GREETINGS	冬至祭（とうじさい）を祝おう！		
GAMEPLAY_EMOTE_HERO_08B_WOW	すばらしい。		
GAMEPLAY_EMOTE_HERO_09_CONCEDE	恐れ入りました。		
GAMEPLAY_EMOTE_HERO_09_ERROR_FULL_MINIONS	ミニオンが多過ぎますね。		
GAMEPLAY_EMOTE_HERO_09_ERROR_GENERIC	それはできません。		
GAMEPLAY_EMOTE_HERO_09_ERROR_HAND_FULL	手札が多過ぎます！		
GAMEPLAY_EMOTE_HERO_09_ERROR_I_ATTACKED	僕はもう攻撃しました。		
GAMEPLAY_EMOTE_HERO_09_ERROR_JUST_PLAYED	そのミニオンが動けるのは次のターンからです。		
GAMEPLAY_EMOTE_HERO_09_ERROR_MINION_ATTACKED	そのミニオンは攻撃済みです。		
GAMEPLAY_EMOTE_HERO_09_ERROR_NEED_MANA	マナが足りません。		
GAMEPLAY_EMOTE_HERO_09_ERROR_NEED_WEAPON	武器が必要です。		
GAMEPLAY_EMOTE_HERO_09_ERROR_PLAY	今そのカードは使えません。		
GAMEPLAY_EMOTE_HERO_09_ERROR_STEALTH	隠れ身しているミニオンは攻撃できません。		
GAMEPLAY_EMOTE_HERO_09_ERROR_TARGET	それは対象にはできませんね。		
GAMEPLAY_EMOTE_HERO_09_ERROR_TAUNT	「挑発」を持つミニオンが邪魔です。		
GAMEPLAY_EMOTE_HERO_09_EVENT_LUNAR_NEW_YEAR	よろしく！		
GAMEPLAY_EMOTE_HERO_09_GOOD_GAME	よい勝負でした！		
GAMEPLAY_EMOTE_HERO_09_GREETINGS	よろしく！		
GAMEPLAY_EMOTE_HERO_09_LOW_CARDS	もうすぐカードが尽きる！		
GAMEPLAY_EMOTE_HERO_09_MIRROR_START	光は正しき者に微笑む！		
GAMEPLAY_EMOTE_HERO_09_NO_CARDS	カードが尽きてしまった！		
GAMEPLAY_EMOTE_HERO_09_OOPS	目論見が外れましたね…		
GAMEPLAY_EMOTE_HERO_09_SORRY	失礼しました。		
GAMEPLAY_EMOTE_HERO_09_START	光が勝利をもたらさんことを！		
GAMEPLAY_EMOTE_HERO_09_THANKS	感謝します。		
GAMEPLAY_EMOTE_HERO_09_THINK1	ふむ…		
GAMEPLAY_EMOTE_HERO_09_THINK2	何をするべきか…		
GAMEPLAY_EMOTE_HERO_09_THINK3	決断しなくては…		
GAMEPLAY_EMOTE_HERO_09_THREATEN	光の浄化を受けよ！		
GAMEPLAY_EMOTE_HERO_09_TIMER	決断しなくては！		
GAMEPLAY_EMOTE_HERO_09_WELL_PLAYED	お見事です。		
GAMEPLAY_EMOTE_HERO_09_WINTERVEIL_GREETINGS	冬至祭を祝いましょう！		
GAMEPLAY_EMOTE_HERO_09_WOW	わぁっ…		
GAMEPLAY_EMOTE_HERO_TBKTRAF_KT_CONCEDE	この…借りは…返すぞ…		
GAMEPLAY_EMOTE_HERO_TBKTRAF_KT_GREETINGS	ついに我が前に現れたか！		
GAMEPLAY_EMOTE_HERO_TBKTRAF_KT_LOW_CARDS	我がカードが尽きかけている！		
GAMEPLAY_EMOTE_HERO_TBKTRAF_KT_NO_CARDS	おのれ！！！呪われよ、侵入者め！		
GAMEPLAY_EMOTE_HERO_TBKTRAF_KT_OOPS	ハァ…設計図から作り直しか…		
GAMEPLAY_EMOTE_HERO_TBKTRAF_KT_SORRY	おのれ！呪われよ、侵入者め！		
GAMEPLAY_EMOTE_HERO_TBKTRAF_KT_START	我の前まで来るがよい、侵入者よ！		
GAMEPLAY_EMOTE_HERO_TBKTRAF_KT_THANKS	どう…いたしまして？		
GAMEPLAY_EMOTE_HERO_TBKTRAF_KT_THINK1	これはどうだ？ 		
GAMEPLAY_EMOTE_HERO_TBKTRAF_KT_THINK2	よし…よぉし！		
GAMEPLAY_EMOTE_HERO_TBKTRAF_KT_THINK3	どう思う、ビグルスワース君？		
GAMEPLAY_EMOTE_HERO_TBKTRAF_KT_THREATEN	その体に流れる血を凍てつかせてくれよう！		
GAMEPLAY_EMOTE_HERO_TBKTRAF_KT_WELL_PLAYED	ハー、当たり前のことを。我は「あの」ケルスザードなのだぞ！		
GAMEPLAY_EMOTE_HERO_TBKTRAF_RAF_CONCEDE	バカな！我が負けるはずなんてない！		
GAMEPLAY_EMOTE_HERO_TBKTRAF_RAF_GREETINGS	ようこそ、探検家よ。		
GAMEPLAY_EMOTE_HERO_TBKTRAF_RAF_LOW_CARDS	我がカードが尽きかけているとは！		
GAMEPLAY_EMOTE_HERO_TBKTRAF_RAF_NO_CARDS	我が美しき宝が！		
GAMEPLAY_EMOTE_HERO_TBKTRAF_RAF_OOPS	失敗だ！		
GAMEPLAY_EMOTE_HERO_TBKTRAF_RAF_SORRY	哀れだな。		
GAMEPLAY_EMOTE_HERO_TBKTRAF_RAF_START	ラファーム！頂点たる考古学者なり！		
GAMEPLAY_EMOTE_HERO_TBKTRAF_RAF_THANKS	ああ、感謝する。		
GAMEPLAY_EMOTE_HERO_TBKTRAF_RAF_THINK1	うぬぬぬ…		
GAMEPLAY_EMOTE_HERO_TBKTRAF_RAF_THINK2	どれをいただこう…		
GAMEPLAY_EMOTE_HERO_TBKTRAF_RAF_THINK3	まさに垂涎…		
GAMEPLAY_EMOTE_HERO_TBKTRAF_RAF_THREATEN	この圧倒的なパワー！		
GAMEPLAY_EMOTE_HERO_TBKTRAF_RAF_WELL_PLAYED	お見事		
GAMEPLAY_EMOTE_HERO_TBMECHWAR01_CONCEDE	<敗北宣言>	The text is in brackets because the VO files is just Annoy-o-Tron's greeting	
GAMEPLAY_EMOTE_HERO_TBMECHWAR01_ERROR_FULL_MINIONS	<エラー！>	The text is in brackets because the VO files is just Annoy-o-Tron's greeting	
GAMEPLAY_EMOTE_HERO_TBMECHWAR01_ERROR_HAND_FULL	<エラー！>	The text is in brackets because the VO files is just Annoy-o-Tron's greeting	
GAMEPLAY_EMOTE_HERO_TBMECHWAR01_ERROR_I_ATTACKED	<エラー！>	The text is in brackets because the VO files is just Annoy-o-Tron's greeting	
GAMEPLAY_EMOTE_HERO_TBMECHWAR01_ERROR_JUST_PLAYED	<エラー！>	The text is in brackets because the VO files is just Annoy-o-Tron's greeting	
GAMEPLAY_EMOTE_HERO_TBMECHWAR01_ERROR_MINION_ATTACKED	<エラー！>	The text is in brackets because the VO files is just Annoy-o-Tron's greeting	
GAMEPLAY_EMOTE_HERO_TBMECHWAR01_ERROR_NEED_MANA	<エラー！>	The text is in brackets because the VO files is just Annoy-o-Tron's greeting	
GAMEPLAY_EMOTE_HERO_TBMECHWAR01_ERROR_NEED_WEAPON	<エラー！>	The text is in brackets because the VO files is just Annoy-o-Tron's greeting	
GAMEPLAY_EMOTE_HERO_TBMECHWAR01_ERROR_PLAY	<エラー！>	The text is in brackets because the VO files is just Annoy-o-Tron's greeting	
GAMEPLAY_EMOTE_HERO_TBMECHWAR01_ERROR_STEALTH	<エラー！>	The text is in brackets because the VO files is just Annoy-o-Tron's greeting	
GAMEPLAY_EMOTE_HERO_TBMECHWAR01_ERROR_TARGET	<エラー！>	The text is in brackets because the VO files is just Annoy-o-Tron's greeting	
GAMEPLAY_EMOTE_HERO_TBMECHWAR01_ERROR_TAUNT	<エラー！>	The text is in brackets because the VO files is just Annoy-o-Tron's greeting	
GAMEPLAY_EMOTE_HERO_TBMECHWAR01_GREETINGS	<あいさつ>	The text is in brackets because the VO files is just Annoy-o-Tron's greeting	
GAMEPLAY_EMOTE_HERO_TBMECHWAR01_LOW_CARDS	<カードが残りわずかです>	The text is in brackets because the VO files is just Annoy-o-Tron's greeting	
GAMEPLAY_EMOTE_HERO_TBMECHWAR01_NO_CARDS	<カードが無くなりました>	The text is in brackets because the VO files is just Annoy-o-Tron's greeting	
GAMEPLAY_EMOTE_HERO_TBMECHWAR01_OOPS	<エラー>	The text is in brackets because the VO files is just Annoy-o-Tron's greeting	
GAMEPLAY_EMOTE_HERO_TBMECHWAR01_SORRY	<謝罪>	The text is in brackets because the VO files is just Annoy-o-Tron's greeting	
GAMEPLAY_EMOTE_HERO_TBMECHWAR01_START	<開始>	The text is in brackets because the VO files is just Annoy-o-Tron's greeting	
GAMEPLAY_EMOTE_HERO_TBMECHWAR01_THANKS	<感謝>	The text is in brackets because the VO files is just Annoy-o-Tron's greeting	
GAMEPLAY_EMOTE_HERO_TBMECHWAR01_THINK1	<処理中…>	The text is in brackets because the VO files is just Annoy-o-Tron's greeting	
GAMEPLAY_EMOTE_HERO_TBMECHWAR01_THINK2	<標的を捕捉中…>	The text is in brackets because the VO files is just Annoy-o-Tron's greeting	
GAMEPLAY_EMOTE_HERO_TBMECHWAR01_THINK3	<CPUサイクルを無駄遣い中…>	The text is in brackets because the VO files is just Annoy-o-Tron's greeting	
GAMEPLAY_EMOTE_HERO_TBMECHWAR01_THREATEN	<威嚇>	The text is in brackets because the VO files is just Annoy-o-Tron's attack	
GAMEPLAY_EMOTE_HERO_TBMECHWAR01_TIMER	<持ち時間が残りわずかです>	The text is in brackets because the VO files is just Annoy-o-Tron's greeting	
GAMEPLAY_EMOTE_HERO_TBMECHWAR01_WELL_PLAYED	<賞賛>	The text is in brackets because the VO files is just Annoy-o-Tron's greeting	
GAMEPLAY_EMOTE_HERO_TBMECHWAR02_CONCEDE	<行の終わり>	The text is in brackets because the VO files is just Boom Bot's greeting	
GAMEPLAY_EMOTE_HERO_TBMECHWAR02_ERROR_FULL_MINIONS	<エラー！>	The text is in brackets because the VO files is just Boom Bot's greeting	
GAMEPLAY_EMOTE_HERO_TBMECHWAR02_ERROR_HAND_FULL	<エラー！>	The text is in brackets because the VO files is just Boom Bot's greeting	
GAMEPLAY_EMOTE_HERO_TBMECHWAR02_ERROR_I_ATTACKED	<エラー！>	The text is in brackets because the VO files is just Boom Bot's greeting	
GAMEPLAY_EMOTE_HERO_TBMECHWAR02_ERROR_JUST_PLAYED	<エラー！>	The text is in brackets because the VO files is just Boom Bot's greeting	
GAMEPLAY_EMOTE_HERO_TBMECHWAR02_ERROR_MINION_ATTACKED	<エラー！>	The text is in brackets because the VO files is just Boom Bot's greeting	
GAMEPLAY_EMOTE_HERO_TBMECHWAR02_ERROR_NEED_MANA	<エラー！>	The text is in brackets because the VO files is just Boom Bot's greeting	
GAMEPLAY_EMOTE_HERO_TBMECHWAR02_ERROR_NEED_WEAPON	<エラー！>	The text is in brackets because the VO files is just Boom Bot's greeting	
GAMEPLAY_EMOTE_HERO_TBMECHWAR02_ERROR_PLAY	<エラー！>	The text is in brackets because the VO files is just Boom Bot's greeting	
GAMEPLAY_EMOTE_HERO_TBMECHWAR02_ERROR_STEALTH	<エラー！>	The text is in brackets because the VO files is just Boom Bot's greeting	
GAMEPLAY_EMOTE_HERO_TBMECHWAR02_ERROR_TARGET	<エラー！>	The text is in brackets because the VO files is just Boom Bot's greeting	
GAMEPLAY_EMOTE_HERO_TBMECHWAR02_ERROR_TAUNT	<エラー！>	The text is in brackets because the VO files is just Boom Bot's greeting	
GAMEPLAY_EMOTE_HERO_TBMECHWAR02_GREETINGS	<あいさつ>	The text is in brackets because the VO files is just Annoy-o-Tron's greeting	
GAMEPLAY_EMOTE_HERO_TBMECHWAR02_LOW_CARDS	<カードが残りわずかです>	The text is in brackets because the VO files is just Boom Bot's greeting	
GAMEPLAY_EMOTE_HERO_TBMECHWAR02_NO_CARDS	<カードが尽きました！>	The text is in brackets because the VO files is just Boom Bot's greeting	
GAMEPLAY_EMOTE_HERO_TBMECHWAR02_OOPS	<エラー！>	The text is in brackets because the VO files is just Boom Bot's greeting	
GAMEPLAY_EMOTE_HERO_TBMECHWAR02_SORRY	<失敬>	The text is in brackets because the VO files is just Boom Bot's greeting	
GAMEPLAY_EMOTE_HERO_TBMECHWAR02_START	<起動>	The text is in brackets because the VO files is just Boom Bot's greeting	
GAMEPLAY_EMOTE_HERO_TBMECHWAR02_THANKS	<ありがとうございます>	The text is in brackets because the VO files is just Boom Bot's greeting	
GAMEPLAY_EMOTE_HERO_TBMECHWAR02_THINK1	<処理中…>	The text is in brackets because the VO files is just Boom Bot's greeting	
GAMEPLAY_EMOTE_HERO_TBMECHWAR02_THINK2	<標的を捕捉中…>	The text is in brackets because the VO files is just Boom Bot's greeting	
GAMEPLAY_EMOTE_HERO_TBMECHWAR02_THINK3	<CPUサイクルを無駄遣い中…>	The text is in brackets because the VO files is just Boom Bot's greeting	
GAMEPLAY_EMOTE_HERO_TBMECHWAR02_THREATEN	<威嚇！>	The text is in brackets because the VO files is just Boom Bot's Attack sound	
GAMEPLAY_EMOTE_HERO_TBMECHWAR02_TIMER	<持ち時間が残りわずかです>	The text is in brackets because the VO files is just Boom Bot's greeting	
GAMEPLAY_EMOTE_HERO_TBMECHWAR02_WELL_PLAYED	<賞賛>	The text is in brackets because the VO files is just Boom Bot's greeting	
VO_BRM_027h__LUNAR_NEW_YEAR	炎に浄められよ！		
VO_BRM_027h_Attack_15	サルファロンの炎を味わえぇい！		
VO_BRM_027h_Concede_11	貴様の勝ちだ！楽しめたぞ！		
VO_BRM_027h_Emote_Start	恨みはらさでおくべきか、ドラゴンめ！		
VO_BRM_027h_ERROR01_51	武器がいるぞ。		
VO_BRM_027h_ERROR02_52	マナが足りんぞ。		
VO_BRM_027h_ERROR03_53	そいつは既に攻撃しておる。		
VO_BRM_027h_ERROR04_54	我は既に攻撃しておる。		
VO_BRM_027h_ERROR05_55	下等生物は次のターンにならねば動けんのだ。		
VO_BRM_027h_ERROR06_56	カードが多過ぎるぞ。		
VO_BRM_027h_ERROR07_57	ミニオンが多過ぎるな。		
VO_BRM_027h_ERROR08_58	ふん、隠れた虫ケラは狙えんな。		
VO_BRM_027h_ERROR09_59	今そのカードは使えんな。		
VO_BRM_027h_ERROR10_60	そいつには使えん。		
VO_BRM_027h_ERROR11_61	あの挑発しておるミニオンが邪魔だ。		
VO_BRM_027h_ERROR12_62	それはできんな。		
VO_BRM_027h_GG_16	楽しめたぞ！		
VO_BRM_027h_Greetings_04	炎に浄められよ！		
VO_BRM_027h_HAPPY_NEW_YEAR_38	見よ！初日は赤く燃えている！		
VO_BRM_027h_LowCards_49	ぬぅ、我がデッキが燃え尽きる。		
VO_BRM_027h_NoCards_50	我がデッキが燃え尽きたか。		
VO_BRM_027h_Oops_07	ぐぁっ！しくじった！		
VO_BRM_027h_Sorry_10	悪く思うな。		
VO_BRM_027h_Thanks_09	熱い感謝を。		
VO_BRM_027h_Thinking1_12	ふむ…		
VO_BRM_027h_Thinking2_13	さーて…		
VO_BRM_027h_Thinking3_14	どいつから燃やすか…		
VO_BRM_027h_Threaten_08	炎に飲まれてくたばるがいい！		
VO_BRM_027h_Time_48	我の尻に火がついておるとは！		
VO_BRM_027h_Well_Played_06	フンッ！見事だ。		
VO_BRM_027h_Winterveil_Greetings	いいものだな、クリスマスキャンドルの灯火は！		
VO_BRM_027h_WOW_20	アツイな。		
VO_TBA01_4__Concede	ウゥゥ～～～ッ！		
VO_TBA01_4__Error_Full_Minions	ウゥゥ～～～ッ！		
VO_TBA01_4__Error_Generic	ウゥゥ～～～ッ！		
VO_TBA01_4__Error_Hand_Full	ウゥゥ～～～ッ！		
VO_TBA01_4__Error_I_Attacked	ウゥゥ～～～ッ！		
VO_TBA01_4__Error_Just_Played	ウゥゥ～～～ッ！		
VO_TBA01_4__Error_Minion_Attacked	ウゥゥ～～～ッ！		
VO_TBA01_4__Error_Need_Mana	ウゥゥ～～～ッ！		
VO_TBA01_4__Error_Need_Weapon	ウゥゥ～～～ッ！		
VO_TBA01_4__Error_Play	ウゥゥ～～～ッ！		
VO_TBA01_4__Error_Stealth	ウゥゥ～～～ッ！		
VO_TBA01_4__Good_Game	ウゥゥ～～～ッ！		
VO_TBA01_4__Greetings	さぁ、ゲームを始めようか！		
VO_TBA01_4__Low_Cards	ウゥゥ～～～ッ！		
VO_TBA01_4__No_Cards	ウゥゥ～～～ッ！		
VO_TBA01_4__Oops	おおっと。		
VO_TBA01_4__Sorry	失敬。		
VO_TBA01_4__Start	ここの支配者は私だ！		
VO_TBA01_4__Thanks	感謝。		
VO_TBA01_4__Threaten	見るがよい。慄くがよい。このネファリアンの真の力！		
VO_TBA01_4__Timer	ウゥゥ～～～ッ！		
VO_TBA01_4__Well_Played	大したものだ。		
