TAG	TEXT	COMMENT	AUDIOFILE
GAMEPLAY_EMOTE_EX1_323h_CONCEDE	네가 이겼다... 하지만 네 세계는 여전히 파멸하리라!		
GAMEPLAY_EMOTE_EX1_323h_ERROR_FULL_MINIONS	하수인이 너무 많아!		
GAMEPLAY_EMOTE_EX1_323h_ERROR_GENERIC	그럴 수 없어!		
GAMEPLAY_EMOTE_EX1_323h_ERROR_HAND_FULL	카드가 너무 많아!		
GAMEPLAY_EMOTE_EX1_323h_ERROR_I_ATTACKED	난 이미 공격했다!		
GAMEPLAY_EMOTE_EX1_323h_ERROR_JUST_PLAYED	방금 나왔잖아!		
GAMEPLAY_EMOTE_EX1_323h_ERROR_MINION_ATTACKED	그 녀석은 이미 공격했다!		
GAMEPLAY_EMOTE_EX1_323h_ERROR_NEED_MANA	마나가 없다!		
GAMEPLAY_EMOTE_EX1_323h_ERROR_NEED_WEAPON	내 무기가 어디갔지?!		
GAMEPLAY_EMOTE_EX1_323h_ERROR_PLAY	그건 낼 수 없어!		
GAMEPLAY_EMOTE_EX1_323h_ERROR_STEALTH	은신 중이잖아!		
GAMEPLAY_EMOTE_EX1_323h_ERROR_TARGET	유효한 대상이 아니야!		
GAMEPLAY_EMOTE_EX1_323h_ERROR_TAUNT	저 하수인의 도발 능력이 짜증나게 하잖아!		
GAMEPLAY_EMOTE_EX1_323h_GOOD_GAME	멋진 승부였다!		
GAMEPLAY_EMOTE_EX1_323h_GREETINGS	불타는 군단의 에레다르 군주, 자락서스 님이 상대해 주마!		
GAMEPLAY_EMOTE_EX1_323h_LOW_CARDS	이런! 덱에 카드가 거의 없다!		
GAMEPLAY_EMOTE_EX1_323h_LUNAR_NEW_YEAR	흥, 설날 따위 즐겁게 보내버려라!		
GAMEPLAY_EMOTE_EX1_323h_NO_CARDS	안 돼! 카드가 다 떨어졌다!		
GAMEPLAY_EMOTE_EX1_323h_OOPS	실수군!		
GAMEPLAY_EMOTE_EX1_323h_SORRY	자락서스는... 미안하다.		
GAMEPLAY_EMOTE_EX1_323h_THANKS	고맙군.		
GAMEPLAY_EMOTE_EX1_323h_THINK1	흠...		
GAMEPLAY_EMOTE_EX1_323h_THINK2	그렇다면...		
GAMEPLAY_EMOTE_EX1_323h_THINK3	어떻게 끝장을 낼까...		
GAMEPLAY_EMOTE_EX1_323h_THREATEN	뼈에서 살을!		
GAMEPLAY_EMOTE_EX1_323h_TIMER	시간이 없다!		
GAMEPLAY_EMOTE_EX1_323h_WELL_PLAYED	제법 하는군.		
GAMEPLAY_EMOTE_EX1_323h_WINTERVEIL_GREETINGS	이번 겨울맞이 축제 때 네 영혼을 먹어치우리라!		
GAMEPLAY_EMOTE_HERO_01_CONCEDE	난 죽음을 택하겠다!		
GAMEPLAY_EMOTE_HERO_01_ERROR_FULL_MINIONS	하수인이 너무 많아.		
GAMEPLAY_EMOTE_HERO_01_ERROR_GENERIC	그렇겐 못해.		
GAMEPLAY_EMOTE_HERO_01_ERROR_HAND_FULL	카드가 너무 많아!		
GAMEPLAY_EMOTE_HERO_01_ERROR_I_ATTACKED	난 이미 공격했다.		
GAMEPLAY_EMOTE_HERO_01_ERROR_JUST_PLAYED	그 하수인은 다음 턴에 준비될 거다.		
GAMEPLAY_EMOTE_HERO_01_ERROR_MINION_ATTACKED	그 하수인은 이미 공격했다.		
GAMEPLAY_EMOTE_HERO_01_ERROR_NEED_MANA	마나가 부족하군.		
GAMEPLAY_EMOTE_HERO_01_ERROR_NEED_WEAPON	무기가 필요하다.		
GAMEPLAY_EMOTE_HERO_01_ERROR_PLAY	그 카드는 낼 수 없다.		
GAMEPLAY_EMOTE_HERO_01_ERROR_STEALTH	은신 중인 하수인은 선택할 수 없다.		
GAMEPLAY_EMOTE_HERO_01_ERROR_TARGET	선택할 수 없는 대상이다.		
GAMEPLAY_EMOTE_HERO_01_ERROR_TAUNT	도발 능력이 있는 하수인이 가로막고 있다!		
GAMEPLAY_EMOTE_HERO_01_EVENT_LUNAR_NEW_YEAR	새해 복 많이 받아라.		
GAMEPLAY_EMOTE_HERO_01_GOOD_GAME	재미있었다!		
GAMEPLAY_EMOTE_HERO_01_GREETINGS	하, 잘 만났군...		
GAMEPLAY_EMOTE_HERO_01_LOW_CARDS	카드가 거의 없어!		
GAMEPLAY_EMOTE_HERO_01_MIRROR_START	하! 그래, 덤벼봐라!		
GAMEPLAY_EMOTE_HERO_01_NO_CARDS	카드가 없다!		
GAMEPLAY_EMOTE_HERO_01_OOPS	실수였군.		
GAMEPLAY_EMOTE_HERO_01_SORRY	이거 참 미안하군.		
GAMEPLAY_EMOTE_HERO_01_START	승리가 아니면 죽음을!		
GAMEPLAY_EMOTE_HERO_01_THANKS	흐음, 고맙다.		
GAMEPLAY_EMOTE_HERO_01_THINK1	흐음...		
GAMEPLAY_EMOTE_HERO_01_THINK2	음, 글쎄...		
GAMEPLAY_EMOTE_HERO_01_THINK3	이젠 뭘 할까...		
GAMEPLAY_EMOTE_HERO_01_THREATEN	널 박살내 주마!		
GAMEPLAY_EMOTE_HERO_01_TIMER	으! 선택해야 한다!		
GAMEPLAY_EMOTE_HERO_01_WELL_PLAYED	아주 잘했다.		
GAMEPLAY_EMOTE_HERO_01_WINTERVEIL_GREETINGS	겨울맞이 축제를 즐겨라!		
GAMEPLAY_EMOTE_HERO_01A_CONCEDE	아, 그대가 이겼네!		
GAMEPLAY_EMOTE_HERO_01A_ERROR_FULL_MINIONS	하수인이 너무 많네.		
GAMEPLAY_EMOTE_HERO_01A_ERROR_GENERIC	그건 할 수 없네.		
GAMEPLAY_EMOTE_HERO_01A_ERROR_HAND_FULL	어허, 카드가 너무 많군!		
GAMEPLAY_EMOTE_HERO_01A_ERROR_I_ATTACKED	난 이미 공격했다네.		
GAMEPLAY_EMOTE_HERO_01A_ERROR_JUST_PLAYED	그 하수인은 다음 턴에 준비될 걸세.		
GAMEPLAY_EMOTE_HERO_01A_ERROR_MINION_ATTACKED	그 하수인은 이미 공격했네.		
GAMEPLAY_EMOTE_HERO_01A_ERROR_NEED_MANA	마나가 부족하군.		
GAMEPLAY_EMOTE_HERO_01A_ERROR_NEED_WEAPON	무기가 필요하다네.		
GAMEPLAY_EMOTE_HERO_01A_ERROR_PLAY	그 카드는 낼 수 없네.		
GAMEPLAY_EMOTE_HERO_01A_ERROR_STEALTH	은신한 하수인은 선택할 수 없어.		
GAMEPLAY_EMOTE_HERO_01A_ERROR_TARGET	선택할 수 없는 대상이야.		
GAMEPLAY_EMOTE_HERO_01A_ERROR_TAUNT	도발 능력이 있는 하수인을 공격해야 하네.		
GAMEPLAY_EMOTE_HERO_01A_EVENT_LUNAR_NEW_YEAR	새해 복 많이 받으라고!		
GAMEPLAY_EMOTE_HERO_01A_GOOD_GAME	멋진 승부였네!		
GAMEPLAY_EMOTE_HERO_01A_GREETINGS	안녕하신가!		
GAMEPLAY_EMOTE_HERO_01A_LOW_CARDS	카드가 거의 없네!		
GAMEPLAY_EMOTE_HERO_01A_MIRROR_START	그래, 카즈 모단을 위하여!		
GAMEPLAY_EMOTE_HERO_01A_NO_CARDS	이런, 카드가 없지 않나!		
GAMEPLAY_EMOTE_HERO_01A_OOPS	어이쿠... 저런...		
GAMEPLAY_EMOTE_HERO_01A_SORRY	미안하네, 친구.		
GAMEPLAY_EMOTE_HERO_01A_START	카즈 모단을 위하여!		
GAMEPLAY_EMOTE_HERO_01A_THANKS	오호! 고맙네!		
GAMEPLAY_EMOTE_HERO_01A_THINK1	흐음...		
GAMEPLAY_EMOTE_HERO_01A_THINK2	이걸로? 아니, 아냐...		
GAMEPLAY_EMOTE_HERO_01A_THINK3	할 게 너무 많잖아...		
GAMEPLAY_EMOTE_HERO_01A_THREATEN	산의 분노를 느껴 보게나!		
GAMEPLAY_EMOTE_HERO_01A_TIMER	이런! 뭐든 해야겠군!		
GAMEPLAY_EMOTE_HERO_01A_WELL_PLAYED	잘했네.		
GAMEPLAY_EMOTE_HERO_01A_WINTERVEIL_GREETINGS	즐거운 겨울맞이 축제 보내게나!		
GAMEPLAY_EMOTE_HERO_02_CONCEDE	이번엔 자네가 이겼군, 친구.		
GAMEPLAY_EMOTE_HERO_02_ERROR_FULL_MINIONS	하수인이 너무 많네.		
GAMEPLAY_EMOTE_HERO_02_ERROR_GENERIC	그렇게는 할 수 없네.		
GAMEPLAY_EMOTE_HERO_02_ERROR_HAND_FULL	카드가 너무 많네!		
GAMEPLAY_EMOTE_HERO_02_ERROR_I_ATTACKED	나는 이미 공격했네.		
GAMEPLAY_EMOTE_HERO_02_ERROR_JUST_PLAYED	그 하수인은 다음 턴에 준비될 걸세.		
GAMEPLAY_EMOTE_HERO_02_ERROR_MINION_ATTACKED	그 하수인은 이미 공격했네.		
GAMEPLAY_EMOTE_HERO_02_ERROR_NEED_MANA	마나가 부족하네.		
GAMEPLAY_EMOTE_HERO_02_ERROR_NEED_WEAPON	무기가 필요하네.		
GAMEPLAY_EMOTE_HERO_02_ERROR_PLAY	그 카드는 낼 수 없네.		
GAMEPLAY_EMOTE_HERO_02_ERROR_STEALTH	은신 중인 하수인은 선택할 수 없네.		
GAMEPLAY_EMOTE_HERO_02_ERROR_TARGET	선택할 수 없는 대상이네.		
GAMEPLAY_EMOTE_HERO_02_ERROR_TAUNT	도발 능력이 있는 하수인이 가로막고 있네!		
GAMEPLAY_EMOTE_HERO_02_EVENT_LUNAR_NEW_YEAR	새해 복 많이 받게, 친구여.		
GAMEPLAY_EMOTE_HERO_02_GOOD_GAME	좋은 승부였네!		
GAMEPLAY_EMOTE_HERO_02_GREETINGS	반갑네, 친구!		
GAMEPLAY_EMOTE_HERO_02_LOW_CARDS	카드가 거의 없네!		
GAMEPLAY_EMOTE_HERO_02_MIRROR_START	서리늑대 부족을 위하여!		
GAMEPLAY_EMOTE_HERO_02_NO_CARDS	카드가 없어!		
GAMEPLAY_EMOTE_HERO_02_OOPS	실수였네.		
GAMEPLAY_EMOTE_HERO_02_SORRY	안타깝군.		
GAMEPLAY_EMOTE_HERO_02_START	둠해머를 위하여!		
GAMEPLAY_EMOTE_HERO_02_THANKS	고맙네.		
GAMEPLAY_EMOTE_HERO_02_THINK1	흠...		
GAMEPLAY_EMOTE_HERO_02_THINK2	이건 어떨까...		
GAMEPLAY_EMOTE_HERO_02_THINK3	흠... 어떻게 할까...		
GAMEPLAY_EMOTE_HERO_02_THREATEN	정령들이 자네를 파괴할 걸세!		
GAMEPLAY_EMOTE_HERO_02_TIMER	시간이 없네!		
GAMEPLAY_EMOTE_HERO_02_WELL_PLAYED	잘했네.		
GAMEPLAY_EMOTE_HERO_02_WINTERVEIL_GREETINGS	즐거운 겨울맞이 축제 보내게나.		
GAMEPLAY_EMOTE_HERO_03_CONCEDE	포기하겠어.		
GAMEPLAY_EMOTE_HERO_03_ERROR_FULL_MINIONS	하수인이 너무 많아.		
GAMEPLAY_EMOTE_HERO_03_ERROR_GENERIC	그렇게는 못해.		
GAMEPLAY_EMOTE_HERO_03_ERROR_HAND_FULL	카드가 너무 많아!		
GAMEPLAY_EMOTE_HERO_03_ERROR_I_ATTACKED	난 이미 공격했어.		
GAMEPLAY_EMOTE_HERO_03_ERROR_JUST_PLAYED	그 하수인은 다음 턴에 준비될 거야.		
GAMEPLAY_EMOTE_HERO_03_ERROR_MINION_ATTACKED	그 하수인은 이미 공격했어.		
GAMEPLAY_EMOTE_HERO_03_ERROR_NEED_MANA	마나가 부족해.		
GAMEPLAY_EMOTE_HERO_03_ERROR_NEED_WEAPON	무기가 필요한데.		
GAMEPLAY_EMOTE_HERO_03_ERROR_PLAY	그 카드는 사용할 수 없는데.		
GAMEPLAY_EMOTE_HERO_03_ERROR_STEALTH	은신 중인 하수인은 선택할 수 없어.		
GAMEPLAY_EMOTE_HERO_03_ERROR_TARGET	선택할 수 있는 대상이 아니야.		
GAMEPLAY_EMOTE_HERO_03_ERROR_TAUNT	도발 능력이 있는 하수인이 가로막고 있어!		
GAMEPLAY_EMOTE_HERO_03_EVENT_LUNAR_NEW_YEAR	새해에도 잘 부탁해.		
GAMEPLAY_EMOTE_HERO_03_GOOD_GAME	좋은 승부였어!		
GAMEPLAY_EMOTE_HERO_03_GREETINGS	잘 부탁해.		
GAMEPLAY_EMOTE_HERO_03_LOW_CARDS	카드가 거의 없어!		
GAMEPLAY_EMOTE_HERO_03_MIRROR_START	남 걱정할 때가 아닐텐데?		
GAMEPLAY_EMOTE_HERO_03_NO_CARDS	카드가 없어!		
GAMEPLAY_EMOTE_HERO_03_OOPS	때로는 실수도 하는 법...		
GAMEPLAY_EMOTE_HERO_03_SORRY	방금 건 미안하군.		
GAMEPLAY_EMOTE_HERO_03_START	등... 뒤를... 조심해...		
GAMEPLAY_EMOTE_HERO_03_THANKS	고마워.		
GAMEPLAY_EMOTE_HERO_03_THINK1	흠...		
GAMEPLAY_EMOTE_HERO_03_THINK2	이건 어떨까...		
GAMEPLAY_EMOTE_HERO_03_THINK3	선택지가 정말 많아...		
GAMEPLAY_EMOTE_HERO_03_THREATEN	숨통을 끊어주지!		
GAMEPLAY_EMOTE_HERO_03_TIMER	빨리 선택해야 해.		
GAMEPLAY_EMOTE_HERO_03_WELL_PLAYED	제법인데?		
GAMEPLAY_EMOTE_HERO_03_WINTERVEIL_GREETINGS	겨울맞이 축제, 재밌게 보내!		
GAMEPLAY_EMOTE_HERO_04_CONCEDE	승리는 자네 것일세.		
GAMEPLAY_EMOTE_HERO_04_ERROR_FULL_MINIONS	하수인이 너무 많아.		
GAMEPLAY_EMOTE_HERO_04_ERROR_GENERIC	그렇겐 할 수 없네.		
GAMEPLAY_EMOTE_HERO_04_ERROR_HAND_FULL	카드가 너무 많아!		
GAMEPLAY_EMOTE_HERO_04_ERROR_I_ATTACKED	난 이미 공격했네.		
GAMEPLAY_EMOTE_HERO_04_ERROR_JUST_PLAYED	그 하수인은 다음 턴에 준비될 거야.		
GAMEPLAY_EMOTE_HERO_04_ERROR_MINION_ATTACKED	그 하수인은 이미 공격했네.		
GAMEPLAY_EMOTE_HERO_04_ERROR_NEED_MANA	마나가 부족하군.		
GAMEPLAY_EMOTE_HERO_04_ERROR_NEED_WEAPON	무기가 필요해.		
GAMEPLAY_EMOTE_HERO_04_ERROR_PLAY	그 카드는 낼 수 없다네.		
GAMEPLAY_EMOTE_HERO_04_ERROR_STEALTH	은신 중인 하수인은 선택할 수 없네.		
GAMEPLAY_EMOTE_HERO_04_ERROR_TARGET	선택할 수 없는 대상이야.		
GAMEPLAY_EMOTE_HERO_04_ERROR_TAUNT	도발 능력이 있는 하수인이 가로막고 있다네!		
GAMEPLAY_EMOTE_HERO_04_EVENT_LUNAR_NEW_YEAR	용사여, 즐거운 새해가 되길.		
GAMEPLAY_EMOTE_HERO_04_GOOD_GAME	멋진 승부였네!		
GAMEPLAY_EMOTE_HERO_04_GREETINGS	반갑네.		
GAMEPLAY_EMOTE_HERO_04_LOW_CARDS	카드가 거의 없어!		
GAMEPLAY_EMOTE_HERO_04_MIRROR_START	빛의 힘을 보여주겠네.		
GAMEPLAY_EMOTE_HERO_04_NO_CARDS	카드가 없어!		
GAMEPLAY_EMOTE_HERO_04_OOPS	실수였네.		
GAMEPLAY_EMOTE_HERO_04_SORRY	미안하네.		
GAMEPLAY_EMOTE_HERO_04_START	명예롭게 싸우리라.		
GAMEPLAY_EMOTE_HERO_04_THANKS	고맙네.		
GAMEPLAY_EMOTE_HERO_04_THINK1	흠...		
GAMEPLAY_EMOTE_HERO_04_THINK2	이건 어떨까...		
GAMEPLAY_EMOTE_HERO_04_THINK3	생각 좀 해야겠어...		
GAMEPLAY_EMOTE_HERO_04_THREATEN	정의의 심판을 내려야겠군!		
GAMEPLAY_EMOTE_HERO_04_TIMER	어서 움직여야 해!		
GAMEPLAY_EMOTE_HERO_04_WELL_PLAYED	훌륭하군.		
GAMEPLAY_EMOTE_HERO_04_WINTERVEIL_GREETINGS	흥겨운 겨울맞이 축제로군!		
GAMEPLAY_EMOTE_HERO_04A_CONCEDE	당신의 승리입니다. 항복할게요.		
GAMEPLAY_EMOTE_HERO_04A_ERROR_FULL_MINIONS	하수인이 너무 많습니다.		
GAMEPLAY_EMOTE_HERO_04A_ERROR_GENERIC	그건 할 수 없습니다.		
GAMEPLAY_EMOTE_HERO_04A_ERROR_HAND_FULL	카드가 너무 많아요!		
GAMEPLAY_EMOTE_HERO_04A_ERROR_I_ATTACKED	전 이미 공격했습니다.		
GAMEPLAY_EMOTE_HERO_04A_ERROR_JUST_PLAYED	그 하수인은 다음 턴에 준비될 겁니다.		
GAMEPLAY_EMOTE_HERO_04A_ERROR_MINION_ATTACKED	그 하수인은 이미 공격했어요.		
GAMEPLAY_EMOTE_HERO_04A_ERROR_NEED_MANA	마나가 부족합니다.		
GAMEPLAY_EMOTE_HERO_04A_ERROR_NEED_WEAPON	무기가 필요합니다.		
GAMEPLAY_EMOTE_HERO_04A_ERROR_PLAY	그 카드는 낼 수 없습니다.		
GAMEPLAY_EMOTE_HERO_04A_ERROR_STEALTH	은신한 하수인은 선택할 수 없어요.		
GAMEPLAY_EMOTE_HERO_04A_ERROR_TARGET	선택할 수 없는 대상입니다.		
GAMEPLAY_EMOTE_HERO_04A_ERROR_TAUNT	도발 능력이 있는 하수인을 공격해야 해요.		
GAMEPLAY_EMOTE_HERO_04A_GOOD_GAME	재미있었습니다.		
GAMEPLAY_EMOTE_HERO_04A_GREETINGS	아! 도전자여, 안녕하십니까.		
GAMEPLAY_EMOTE_HERO_04A_LOW_CARDS	카드가 얼마 없습니다.		
GAMEPLAY_EMOTE_HERO_04A_LUNAR_NEW_YEAR	기쁨 가득한 새해를 맞이하세요.		
GAMEPLAY_EMOTE_HERO_04A_MIRROR_START	이봐요, 그건 내 대사라고요.		
GAMEPLAY_EMOTE_HERO_04A_NO_CARDS	카드가 없어요!		
GAMEPLAY_EMOTE_HERO_04A_OOPS	확실히, 실수했군요.		
GAMEPLAY_EMOTE_HERO_04A_SORRY	아, 미안해요.		
GAMEPLAY_EMOTE_HERO_04A_START	제 망치는 신성한 불꽃으로 타오릅니다!		
GAMEPLAY_EMOTE_HERO_04A_THANKS	진심으로 감사드립니다.		
GAMEPLAY_EMOTE_HERO_04A_THINK1	흐음...		
GAMEPLAY_EMOTE_HERO_04A_THINK2	이것도 괜찮고, 저것도 괜찮고...		
GAMEPLAY_EMOTE_HERO_04A_THINK3	이걸로 할까... 흠...		
GAMEPLAY_EMOTE_HERO_04A_THREATEN	하, 각오하십시오!		
GAMEPLAY_EMOTE_HERO_04A_TIMER	어서 결정하죠!		
GAMEPLAY_EMOTE_HERO_04A_WELL_PLAYED	잘하셨습니다.		
GAMEPLAY_EMOTE_HERO_04A_WINTERVEIL_GREETINGS	즐거운 겨울맞이 축제가 되길 기원하겠습니다.		
GAMEPLAY_EMOTE_HERO_05_CONCEDE	잘 싸웠어. 항복하겠네.		
GAMEPLAY_EMOTE_HERO_05_ERROR_FULL_MINIONS	하수인이 너무 많아.		
GAMEPLAY_EMOTE_HERO_05_ERROR_GENERIC	그럴 순 없네.		
GAMEPLAY_EMOTE_HERO_05_ERROR_HAND_FULL	카드가 너무 많아!		
GAMEPLAY_EMOTE_HERO_05_ERROR_I_ATTACKED	난 이미 공격했네.		
GAMEPLAY_EMOTE_HERO_05_ERROR_JUST_PLAYED	그 하수인은 다음 턴에 준비될 거야.		
GAMEPLAY_EMOTE_HERO_05_ERROR_MINION_ATTACKED	그 하수인은 이미 공격했네.		
GAMEPLAY_EMOTE_HERO_05_ERROR_NEED_MANA	마나가 부족해.		
GAMEPLAY_EMOTE_HERO_05_ERROR_NEED_WEAPON	무기가 필요하네.		
GAMEPLAY_EMOTE_HERO_05_ERROR_PLAY	그 카드는 낼 수 없어.		
GAMEPLAY_EMOTE_HERO_05_ERROR_STEALTH	은신 중인 하수인은 선택할 수 없네.		
GAMEPLAY_EMOTE_HERO_05_ERROR_TARGET	선택할 수 없는 대상이야.		
GAMEPLAY_EMOTE_HERO_05_ERROR_TAUNT	도발 능력이 있는 하수인이 가로막고 있네!		
GAMEPLAY_EMOTE_HERO_05_EVENT_LUNAR_NEW_YEAR	여행자여, 새해 복 많이 받게.		
GAMEPLAY_EMOTE_HERO_05_GOOD_GAME	멋진 승부였네!		
GAMEPLAY_EMOTE_HERO_05_GREETINGS	반갑네, 여행자여.		
GAMEPLAY_EMOTE_HERO_05_LOW_CARDS	카드가 거의 없네!		
GAMEPLAY_EMOTE_HERO_05_MIRROR_START	덤벼보게나!		
GAMEPLAY_EMOTE_HERO_05_NO_CARDS	카드가 없어!		
GAMEPLAY_EMOTE_HERO_05_OOPS	그건 좀 실망인데.		
GAMEPLAY_EMOTE_HERO_05_SORRY	내 사과하지.		
GAMEPLAY_EMOTE_HERO_05_START	사냥을 시작하지!		
GAMEPLAY_EMOTE_HERO_05_THANKS	고맙네.		
GAMEPLAY_EMOTE_HERO_05_THINK1	흠...		
GAMEPLAY_EMOTE_HERO_05_THINK2	이러면 어떨까...		
GAMEPLAY_EMOTE_HERO_05_THINK3	흐음...		
GAMEPLAY_EMOTE_HERO_05_THREATEN	네놈을 추격해 주마!		
GAMEPLAY_EMOTE_HERO_05_TIMER	시간은 기다리지 않아!		
GAMEPLAY_EMOTE_HERO_05_WELL_PLAYED	좋은 수였네.		
GAMEPLAY_EMOTE_HERO_05_WINTERVEIL_GREETINGS	겨울맞이 축제를 함께 하세나!		
GAMEPLAY_EMOTE_HERO_05A_CONCEDE	대단하군요. 항복할게요.		
GAMEPLAY_EMOTE_HERO_05A_ERROR_FULL_MINIONS	하수인이 너무 많아요.		
GAMEPLAY_EMOTE_HERO_05A_ERROR_GENERIC	그건 할 수 없어요.		
GAMEPLAY_EMOTE_HERO_05A_ERROR_HAND_FULL	카드가 너무 많다고요!		
GAMEPLAY_EMOTE_HERO_05A_ERROR_I_ATTACKED	전 이미 공격했어요.		
GAMEPLAY_EMOTE_HERO_05A_ERROR_JUST_PLAYED	그 하수인은 다음 턴에 준비될 거예요.		
GAMEPLAY_EMOTE_HERO_05A_ERROR_MINION_ATTACKED	그 하수인은 이미 공격했어요.		
GAMEPLAY_EMOTE_HERO_05A_ERROR_NEED_MANA	마나가 부족해요.		
GAMEPLAY_EMOTE_HERO_05A_ERROR_NEED_WEAPON	무기가 필요해요.		
GAMEPLAY_EMOTE_HERO_05A_ERROR_PLAY	그 카드는 낼 수 없어요.		
GAMEPLAY_EMOTE_HERO_05A_ERROR_STEALTH	은신한 하수인은 선택할 수 없어요.		
GAMEPLAY_EMOTE_HERO_05A_ERROR_TARGET	선택할 수 없는 대상이네요.		
GAMEPLAY_EMOTE_HERO_05A_ERROR_TAUNT	도발 능력이 있는 하수인을 공격해야 해요.		
GAMEPLAY_EMOTE_HERO_05A_EVENT_LUNAR_NEW_YEAR	기쁜 새해가 되길.		
GAMEPLAY_EMOTE_HERO_05A_GOOD_GAME	재미있는 경기였어요.		
GAMEPLAY_EMOTE_HERO_05A_GREETINGS	방랑자여, 안녕하세요.		
GAMEPLAY_EMOTE_HERO_05A_LOW_CARDS	카드가 얼마 없어요.		
GAMEPLAY_EMOTE_HERO_05A_MIRROR_START	전율이라... 그러기엔 부족한데요?		
GAMEPLAY_EMOTE_HERO_05A_NO_CARDS	카드가 하나도 없어요!		
GAMEPLAY_EMOTE_HERO_05A_OOPS	흠, 실수였네요.		
GAMEPLAY_EMOTE_HERO_05A_SORRY	저런... 미안해요.		
GAMEPLAY_EMOTE_HERO_05A_START	엘프의 힘 앞에서 전율하세요!		
GAMEPLAY_EMOTE_HERO_05A_THANKS	고마워요.		
GAMEPLAY_EMOTE_HERO_05A_THINK1	흐음...		
GAMEPLAY_EMOTE_HERO_05A_THINK2	누굴 쏠까?		
GAMEPLAY_EMOTE_HERO_05A_THINK3	어떻게 하지?		
GAMEPLAY_EMOTE_HERO_05A_THREATEN	신속하게 끝내드리죠!		
GAMEPLAY_EMOTE_HERO_05A_TIMER	결정해야 해요! 빨리!		
GAMEPLAY_EMOTE_HERO_05A_WELL_PLAYED	아주 잘했어요.		
GAMEPLAY_EMOTE_HERO_05A_WINTERVEIL_GREETING	즐거운 겨울맞이 축제가 되길 바랄게요.		
GAMEPLAY_EMOTE_HERO_06_CONCEDE	나의 패배를 인정한다.		
GAMEPLAY_EMOTE_HERO_06_ERROR_FULL_MINIONS	하수인이 너무 많다.		
GAMEPLAY_EMOTE_HERO_06_ERROR_GENERIC	그럴 순 없어.		
GAMEPLAY_EMOTE_HERO_06_ERROR_HAND_FULL	카드가 너무 많다!		
GAMEPLAY_EMOTE_HERO_06_ERROR_I_ATTACKED	나는 이미 공격했다.		
GAMEPLAY_EMOTE_HERO_06_ERROR_JUST_PLAYED	그 하수인은 다음 턴에 준비될 것이다.		
GAMEPLAY_EMOTE_HERO_06_ERROR_MINION_ATTACKED	그 하수인은 이미 공격했다.		
GAMEPLAY_EMOTE_HERO_06_ERROR_NEED_MANA	마나가 부족하다.		
GAMEPLAY_EMOTE_HERO_06_ERROR_NEED_WEAPON	무기가 필요하다.		
GAMEPLAY_EMOTE_HERO_06_ERROR_PLAY	그 카드는 낼 수 없다.		
GAMEPLAY_EMOTE_HERO_06_ERROR_STEALTH	은신 중인 하수인은 선택할 수 없어.		
GAMEPLAY_EMOTE_HERO_06_ERROR_TARGET	선택할 수 없는 대상이다.		
GAMEPLAY_EMOTE_HERO_06_ERROR_TAUNT	도발 능력이 있는 하수인이 가로막고 있네!		
GAMEPLAY_EMOTE_HERO_06_EVENT_LUNAR_NEW_YEAR	새해 복 많이 받게나.		
GAMEPLAY_EMOTE_HERO_06_GOOD_GAME	좋은 승부였다!		
GAMEPLAY_EMOTE_HERO_06_GREETINGS	반갑네.		
GAMEPLAY_EMOTE_HERO_06_LOW_CARDS	카드가 거의 없다!		
GAMEPLAY_EMOTE_HERO_06_MIRROR_START	자연은 반드시 보호해야 한다!		
GAMEPLAY_EMOTE_HERO_06_NO_CARDS	카드가 없다!		
GAMEPLAY_EMOTE_HERO_06_OOPS	실수할 수도 있지.		
GAMEPLAY_EMOTE_HERO_06_SORRY	미안하군.		
GAMEPLAY_EMOTE_HERO_06_START	내가 대자연을 수호하겠다!		
GAMEPLAY_EMOTE_HERO_06_THANKS	고맙네.		
GAMEPLAY_EMOTE_HERO_06_THINK1	흠...		
GAMEPLAY_EMOTE_HERO_06_THINK2	흠... 이러면 어떨까?		
GAMEPLAY_EMOTE_HERO_06_THINK3	과연, 어떻게 할까...		
GAMEPLAY_EMOTE_HERO_06_THREATEN	자연이 그대를 거부하리라!		
GAMEPLAY_EMOTE_HERO_06_TIMER	시간은 누구도 기다리지 않는다!		
GAMEPLAY_EMOTE_HERO_06_WELL_PLAYED	흠, 잘했군.		
GAMEPLAY_EMOTE_HERO_06_WINTERVEIL_GREETINGS	겨울맞이 축제를 즐기게나!		
GAMEPLAY_EMOTE_HERO_07_CONCEDE	네 승리는... 이번뿐이다....		
GAMEPLAY_EMOTE_HERO_07_ERROR_FULL_MINIONS	하수인이 너무 많다.		
GAMEPLAY_EMOTE_HERO_07_ERROR_GENERIC	그건 할 수 없다.		
GAMEPLAY_EMOTE_HERO_07_ERROR_HAND_FULL	카드가 너무 많다!		
GAMEPLAY_EMOTE_HERO_07_ERROR_I_ATTACKED	난 이미 공격했다.		
GAMEPLAY_EMOTE_HERO_07_ERROR_JUST_PLAYED	그 하수인은 다음 턴에 준비될 거야.		
GAMEPLAY_EMOTE_HERO_07_ERROR_MINION_ATTACKED	그 하수인은 이미 공격했다.		
GAMEPLAY_EMOTE_HERO_07_ERROR_NEED_MANA	마나가 부족하군.		
GAMEPLAY_EMOTE_HERO_07_ERROR_NEED_WEAPON	무기가 필요해.		
GAMEPLAY_EMOTE_HERO_07_ERROR_PLAY	그 카드는 낼 수 없다.		
GAMEPLAY_EMOTE_HERO_07_ERROR_STEALTH	은신한 하수인은 선택할 수 없어.		
GAMEPLAY_EMOTE_HERO_07_ERROR_TARGET	선택할 수 없는 대상이다.		
GAMEPLAY_EMOTE_HERO_07_ERROR_TAUNT	도발 능력이 있는 하수인이 가로막고 있다!		
GAMEPLAY_EMOTE_HERO_07_EVENT_LUNAR_NEW_YEAR	새해 복 많이 받아라.		
GAMEPLAY_EMOTE_HERO_07_GOOD_GAME	좋은 승부였다!		
GAMEPLAY_EMOTE_HERO_07_GREETINGS	반갑다.		
GAMEPLAY_EMOTE_HERO_07_LOW_CARDS	카드가 거의 없다!		
GAMEPLAY_EMOTE_HERO_07_MIRROR_START	두려움에 떨어라, 나약한 자여!		
GAMEPLAY_EMOTE_HERO_07_NO_CARDS	카드가 다 떨어졌어!		
GAMEPLAY_EMOTE_HERO_07_OOPS	이런, 실수였다.		
GAMEPLAY_EMOTE_HERO_07_SORRY	미안하군.		
GAMEPLAY_EMOTE_HERO_07_START	네 영혼은 내 것이다!		
GAMEPLAY_EMOTE_HERO_07_THANKS	고맙다.		
GAMEPLAY_EMOTE_HERO_07_THINK1	흠...		
GAMEPLAY_EMOTE_HERO_07_THINK2	뭐가 좋을까...		
GAMEPLAY_EMOTE_HERO_07_THINK3	할 수 있는 게 너무 많군...		
GAMEPLAY_EMOTE_HERO_07_THREATEN	네 영혼에 고통을 안겨주마!		
GAMEPLAY_EMOTE_HERO_07_TIMER	시간이 별로 없어!		
GAMEPLAY_EMOTE_HERO_07_WELL_PLAYED	나쁘지 않군.		
GAMEPLAY_EMOTE_HERO_07_WINTERVEIL_GREETINGS	즐거운 겨울맞이 축제로군.		
GAMEPLAY_EMOTE_HERO_08_CONCEDE	이번엔 당신이 이겼어요.		
GAMEPLAY_EMOTE_HERO_08_ERROR_FULL_MINIONS	하수인이 너무 많아요.		
GAMEPLAY_EMOTE_HERO_08_ERROR_GENERIC	그렇게는 못 해요.		
GAMEPLAY_EMOTE_HERO_08_ERROR_HAND_FULL	카드가 너무 많아요!		
GAMEPLAY_EMOTE_HERO_08_ERROR_I_ATTACKED	전 이미 공격했어요.		
GAMEPLAY_EMOTE_HERO_08_ERROR_JUST_PLAYED	그 하수인은 다음 턴에 준비될 거예요.		
GAMEPLAY_EMOTE_HERO_08_ERROR_MINION_ATTACKED	그 하수인은 이미 공격했어요.		
GAMEPLAY_EMOTE_HERO_08_ERROR_NEED_MANA	마나가 부족해요.		
GAMEPLAY_EMOTE_HERO_08_ERROR_NEED_WEAPON	무기가 필요해요.		
GAMEPLAY_EMOTE_HERO_08_ERROR_PLAY	그건 낼 수 없어요.		
GAMEPLAY_EMOTE_HERO_08_ERROR_STEALTH	은신한 하수인은 선택할 수 없어요.		
GAMEPLAY_EMOTE_HERO_08_ERROR_TARGET	선택할 수 없는 대상이에요.		
GAMEPLAY_EMOTE_HERO_08_ERROR_TAUNT	도발 능력이 있는 하수인이 가로막고 있어요!		
GAMEPLAY_EMOTE_HERO_08_EVENT_LUNAR_NEW_YEAR	즐거움 가득한 새해가 되길.		
GAMEPLAY_EMOTE_HERO_08_GOOD_GAME	멋진 승부였어요!		
GAMEPLAY_EMOTE_HERO_08_GREETINGS	반가워요.		
GAMEPLAY_EMOTE_HERO_08_LOW_CARDS	카드가 거의 없어요!		
GAMEPLAY_EMOTE_HERO_08_MIRROR_START	과연 그럴 수 있겠어요?		
GAMEPLAY_EMOTE_HERO_08_NO_CARDS	카드가 없어요!		
GAMEPLAY_EMOTE_HERO_08_OOPS	이런! 실수했네요.		
GAMEPLAY_EMOTE_HERO_08_SORRY	미안해요.		
GAMEPLAY_EMOTE_HERO_08_START	후회하게 해드리죠.		
GAMEPLAY_EMOTE_HERO_08_THANKS	고마워요.		
GAMEPLAY_EMOTE_HERO_08_THINK1	흐음...		
GAMEPLAY_EMOTE_HERO_08_THINK2	글쎄요...		
GAMEPLAY_EMOTE_HERO_08_THINK3	어쩌죠... 어떻게 한담...		
GAMEPLAY_EMOTE_HERO_08_THREATEN	제 마법이 당신을 조각낼 거예요!		
GAMEPLAY_EMOTE_HERO_08_TIMER	시간이 별로 없어요!		
GAMEPLAY_EMOTE_HERO_08_WELL_PLAYED	잘했어요.		
GAMEPLAY_EMOTE_HERO_08_WINTERVEIL_GREETINGS	즐거운 겨울맞이 축제로군요!		
GAMEPLAY_EMOTE_HERO_08A_CONCEDE	결정적이군! 정말 잘했네.		
GAMEPLAY_EMOTE_HERO_08A_ERROR_FULL_MINIONS	하수인이 너무 많네.		
GAMEPLAY_EMOTE_HERO_08A_ERROR_GENERIC	그건 할 수 없네.		
GAMEPLAY_EMOTE_HERO_08A_ERROR_HAND_FULL	카드가 너무 많군!		
GAMEPLAY_EMOTE_HERO_08A_ERROR_I_ATTACKED	난 이미 공격했네.		
GAMEPLAY_EMOTE_HERO_08A_ERROR_JUST_PLAYED	그 하수인은 다음 턴에 준비될 걸세.		
GAMEPLAY_EMOTE_HERO_08A_ERROR_MINION_ATTACKED	그 하수인은 이미 공격했다네.		
GAMEPLAY_EMOTE_HERO_08A_ERROR_NEED_MANA	으... 마나가 부족하군.		
GAMEPLAY_EMOTE_HERO_08A_ERROR_NEED_WEAPON	무기가 필요하다네.		
GAMEPLAY_EMOTE_HERO_08A_ERROR_PLAY	그 카드는 낼 수 없다네.		
GAMEPLAY_EMOTE_HERO_08A_ERROR_STEALTH	은신한 하수인은 선택할 수 없네.		
GAMEPLAY_EMOTE_HERO_08A_ERROR_TARGET	선택할 수 없는 대상일세.		
GAMEPLAY_EMOTE_HERO_08A_ERROR_TAUNT	도발 능력이 있는 하수인을 공격해야 하네.		
GAMEPLAY_EMOTE_HERO_08A_GOOD_GAME	재미있는 게임이었네!		
GAMEPLAY_EMOTE_HERO_08A_GREETINGS	아, 안녕하신가.		
GAMEPLAY_EMOTE_HERO_08A_LOW_CARDS	카드가 얼마 남지 않았네.		
GAMEPLAY_EMOTE_HERO_08A_LUNAR_NEW_YEAR	즐거운 새해가 되길.		
GAMEPLAY_EMOTE_HERO_08A_MIRROR_START	흠, 이미 시작했다네.		
GAMEPLAY_EMOTE_HERO_08A_NO_CARDS	카드가 없네!		
GAMEPLAY_EMOTE_HERO_08A_OOPS	어리석은 행동이었네.		
GAMEPLAY_EMOTE_HERO_08A_SORRY	진심으로 사과하겠네.		
GAMEPLAY_EMOTE_HERO_08A_START	게임을 시작하세!		
GAMEPLAY_EMOTE_HERO_08A_THANKS	감사하네.		
GAMEPLAY_EMOTE_HERO_08A_THINK1	흐음...		
GAMEPLAY_EMOTE_HERO_08A_THINK2	흥미롭군...		
GAMEPLAY_EMOTE_HERO_08A_THINK3	어쩌면...		
GAMEPLAY_EMOTE_HERO_08A_THREATEN	그 무엇도 날 막을 순 없다네!		
GAMEPLAY_EMOTE_HERO_08A_TIMER	가만히 있어서는 안 되네!		
GAMEPLAY_EMOTE_HERO_08A_WELL_PLAYED	잘했네.		
GAMEPLAY_EMOTE_HERO_08A_WINTERVEIL_GREETINGS	도전자여, 축제를 즐기길.		
GAMEPLAY_EMOTE_HERO_08B_CONCEDE	훌륭하군. 그대가 이겼소.		
GAMEPLAY_EMOTE_HERO_08B_ERROR_FULL_MINIONS	하수인이 너무 많소.		
GAMEPLAY_EMOTE_HERO_08B_ERROR_GENERIC	그건 할 수 없소.		
GAMEPLAY_EMOTE_HERO_08B_ERROR_HAND_FULL	카드가 너무 많소!		
GAMEPLAY_EMOTE_HERO_08B_ERROR_I_ATTACKED	난 이미 공격했소.		
GAMEPLAY_EMOTE_HERO_08B_ERROR_JUST_PLAYED	그 하수인은 다음 턴에 준비될 거요.		
GAMEPLAY_EMOTE_HERO_08B_ERROR_MINION_ATTACKED	그 하수인은 이미 공격했소.		
GAMEPLAY_EMOTE_HERO_08B_ERROR_NEED_MANA	마나가 부족하군.		
GAMEPLAY_EMOTE_HERO_08B_ERROR_NEED_WEAPON	무기가 필요하오.		
GAMEPLAY_EMOTE_HERO_08B_ERROR_PLAY	그 카드는 낼 수 없소.		
GAMEPLAY_EMOTE_HERO_08B_ERROR_STEALTH	은신한 하수인은 선택할 수 없소.		
GAMEPLAY_EMOTE_HERO_08B_ERROR_TARGET	선택할 수 없는 대상이오.		
GAMEPLAY_EMOTE_HERO_08B_ERROR_TAUNT	도발 능력이 있는 하수인이 가로막고 있소.		
GAMEPLAY_EMOTE_HERO_08B_GOOD_GAME	참으로 멋진 대결이었소!		
GAMEPLAY_EMOTE_HERO_08B_GREETINGS	반갑소, 진리의 탐구자여.		
GAMEPLAY_EMOTE_HERO_08B_LOW_CARDS	카드가 거의 없소.		
GAMEPLAY_EMOTE_HERO_08B_LUNAR_NEW_YEAR	새해 복 많이 받으시오!		
GAMEPLAY_EMOTE_HERO_08B_MIRROR_START	서로에게서 많은 걸 배우길.		
GAMEPLAY_EMOTE_HERO_08B_NO_CARDS	카드가 없소!		
GAMEPLAY_EMOTE_HERO_08B_OOPS	이런, 실수였군.		
GAMEPLAY_EMOTE_HERO_08B_SORRY	오, 저런. 사과하겠소.		
GAMEPLAY_EMOTE_HERO_08B_START	지식은 곧 힘이오.		
GAMEPLAY_EMOTE_HERO_08B_THANKS	고맙소, 친구여.		
GAMEPLAY_EMOTE_HERO_08B_THINK1	흠...		
GAMEPLAY_EMOTE_HERO_08B_THINK2	관찰하고, 생각한다...		
GAMEPLAY_EMOTE_HERO_08B_THINK3	뭔가 방법이 있을 텐데...		
GAMEPLAY_EMOTE_HERO_08B_THREATEN	한수 똑똑히 가르쳐주겠소!		
GAMEPLAY_EMOTE_HERO_08B_TIMER	시간이 벌써 이렇게 됐나!		
GAMEPLAY_EMOTE_HERO_08B_WELL_PLAYED	잘했소.		
GAMEPLAY_EMOTE_HERO_08B_WINTERVEIL_GREETINGS	즐거운 겨울맞이 축제 보내시오!		
GAMEPLAY_EMOTE_HERO_09_CONCEDE	저보다 훨씬 강하시네요.		
GAMEPLAY_EMOTE_HERO_09_ERROR_FULL_MINIONS	하수인이 너무 많아요.		
GAMEPLAY_EMOTE_HERO_09_ERROR_GENERIC	그건 할 수 없어요.		
GAMEPLAY_EMOTE_HERO_09_ERROR_HAND_FULL	카드가 너무 많아요!		
GAMEPLAY_EMOTE_HERO_09_ERROR_I_ATTACKED	전 이미 공격했어요.		
GAMEPLAY_EMOTE_HERO_09_ERROR_JUST_PLAYED	그 하수인은 다음 턴에 준비될 거예요.		
GAMEPLAY_EMOTE_HERO_09_ERROR_MINION_ATTACKED	그 하수인은 이미 공격했어요.		
GAMEPLAY_EMOTE_HERO_09_ERROR_NEED_MANA	마나가 부족해요.		
GAMEPLAY_EMOTE_HERO_09_ERROR_NEED_WEAPON	무기가 필요해요.		
GAMEPLAY_EMOTE_HERO_09_ERROR_PLAY	그 카드는 낼 수 없어요.		
GAMEPLAY_EMOTE_HERO_09_ERROR_STEALTH	은신 중인 하수인은 선택할 수 없어요.		
GAMEPLAY_EMOTE_HERO_09_ERROR_TARGET	선택할 수 없는 대상이에요.		
GAMEPLAY_EMOTE_HERO_09_ERROR_TAUNT	도발 능력이 있는 하수인이 가로막고 있어요!		
GAMEPLAY_EMOTE_HERO_09_EVENT_LUNAR_NEW_YEAR	새해 복 많이 받으세요!		
GAMEPLAY_EMOTE_HERO_09_GOOD_GAME	좋은 승부였어요!		
GAMEPLAY_EMOTE_HERO_09_GREETINGS	안녕하세요!		
GAMEPLAY_EMOTE_HERO_09_LOW_CARDS	카드가 거의 없어요!		
GAMEPLAY_EMOTE_HERO_09_MIRROR_START	빛은 정의로운 자의 편이죠!		
GAMEPLAY_EMOTE_HERO_09_NO_CARDS	카드가 없어요!		
GAMEPLAY_EMOTE_HERO_09_OOPS	이게 아닌데...		
GAMEPLAY_EMOTE_HERO_09_SORRY	죄송합니다.		
GAMEPLAY_EMOTE_HERO_09_START	빛이 승리를 불러올 것입니다!		
GAMEPLAY_EMOTE_HERO_09_THANKS	감사합니다!		
GAMEPLAY_EMOTE_HERO_09_THINK1	흠...		
GAMEPLAY_EMOTE_HERO_09_THINK2	이건 어떨까...		
GAMEPLAY_EMOTE_HERO_09_THINK3	괜찮을까...		
GAMEPLAY_EMOTE_HERO_09_THREATEN	빛이 당신을 태울 것입니다!		
GAMEPLAY_EMOTE_HERO_09_TIMER	빨리 선택해야 하는데...		
GAMEPLAY_EMOTE_HERO_09_WELL_PLAYED	정말 잘하셨어요.		
GAMEPLAY_EMOTE_HERO_09_WINTERVEIL_GREETINGS	즐거운 겨울맞이 축제 보내세요!		
GAMEPLAY_EMOTE_HERO_TBKTRAF_KT_CONCEDE	나는... 돌아올... 것이다...		
GAMEPLAY_EMOTE_HERO_TBKTRAF_KT_GREETINGS	드디어 만났군.		
GAMEPLAY_EMOTE_HERO_TBKTRAF_KT_LOW_CARDS	카드가 얼마 없다!		
GAMEPLAY_EMOTE_HERO_TBKTRAF_KT_NO_CARDS	안 돼! 저주가 내릴 것이다, 침입자 녀석! 		
GAMEPLAY_EMOTE_HERO_TBKTRAF_KT_OOPS	계획을 다시 짜야겠군.		
GAMEPLAY_EMOTE_HERO_TBKTRAF_KT_SORRY	안 돼! 저주가 내릴 것이다, 침입자 녀석! 		
GAMEPLAY_EMOTE_HERO_TBKTRAF_KT_START	어서 내게 맞서라, 침입자여!		
GAMEPLAY_EMOTE_HERO_TBKTRAF_KT_THANKS	벼... 별말씀을?		
GAMEPLAY_EMOTE_HERO_TBKTRAF_KT_THINK1	이거면 될까?		
GAMEPLAY_EMOTE_HERO_TBKTRAF_KT_THINK2	그래... 그래!		
GAMEPLAY_EMOTE_HERO_TBKTRAF_KT_THINK3	비글스워스 씨, 너라면 어떻게 하겠니?		
GAMEPLAY_EMOTE_HERO_TBKTRAF_KT_THREATEN	네놈 뼛속까지 얼려 주마!		
GAMEPLAY_EMOTE_HERO_TBKTRAF_KT_WELL_PLAYED	하, 당연하지. 나는 위대한 켈투자드 님이다!		
GAMEPLAY_EMOTE_HERO_TBKTRAF_RAF_CONCEDE	안 돼! 내가 패배할 수는 없어...		
GAMEPLAY_EMOTE_HERO_TBKTRAF_RAF_GREETINGS	안녕하신가, 탐험가여.		
GAMEPLAY_EMOTE_HERO_TBKTRAF_RAF_LOW_CARDS	카드가 거의 다 떨어졌다!		
GAMEPLAY_EMOTE_HERO_TBKTRAF_RAF_NO_CARDS	내 보물들이 다 사라졌다!		
GAMEPLAY_EMOTE_HERO_TBKTRAF_RAF_OOPS	실패다!		
GAMEPLAY_EMOTE_HERO_TBKTRAF_RAF_SORRY	불쌍하군.		
GAMEPLAY_EMOTE_HERO_TBKTRAF_RAF_START	위대한 고고학자, 라팜!		
GAMEPLAY_EMOTE_HERO_TBKTRAF_RAF_THANKS	아, 고맙다.		
GAMEPLAY_EMOTE_HERO_TBKTRAF_RAF_THINK1	흐음...		
GAMEPLAY_EMOTE_HERO_TBKTRAF_RAF_THINK2	뭘 낼까...		
GAMEPLAY_EMOTE_HERO_TBKTRAF_RAF_THINK3	이거 괜찮겠는데...		
GAMEPLAY_EMOTE_HERO_TBKTRAF_RAF_THREATEN	압도적인 힘으로!		
GAMEPLAY_EMOTE_HERO_TBKTRAF_RAF_WELL_PLAYED	훌륭하다.		
GAMEPLAY_EMOTE_HERO_TBMECHWAR01_CONCEDE	<항복>	The text is in brackets because the VO files is just Annoy-o-Tron's greeting	
GAMEPLAY_EMOTE_HERO_TBMECHWAR01_ERROR_FULL_MINIONS	<오류 발생!>	The text is in brackets because the VO files is just Annoy-o-Tron's greeting	
GAMEPLAY_EMOTE_HERO_TBMECHWAR01_ERROR_HAND_FULL	<오류 발생!>	The text is in brackets because the VO files is just Annoy-o-Tron's greeting	
GAMEPLAY_EMOTE_HERO_TBMECHWAR01_ERROR_I_ATTACKED	<오류 발생!>	The text is in brackets because the VO files is just Annoy-o-Tron's greeting	
GAMEPLAY_EMOTE_HERO_TBMECHWAR01_ERROR_JUST_PLAYED	<오류 발생!>	The text is in brackets because the VO files is just Annoy-o-Tron's greeting	
GAMEPLAY_EMOTE_HERO_TBMECHWAR01_ERROR_MINION_ATTACKED	<오류 발생!>	The text is in brackets because the VO files is just Annoy-o-Tron's greeting	
GAMEPLAY_EMOTE_HERO_TBMECHWAR01_ERROR_NEED_MANA	<오류 발생!>	The text is in brackets because the VO files is just Annoy-o-Tron's greeting	
GAMEPLAY_EMOTE_HERO_TBMECHWAR01_ERROR_NEED_WEAPON	<오류 발생!>	The text is in brackets because the VO files is just Annoy-o-Tron's greeting	
GAMEPLAY_EMOTE_HERO_TBMECHWAR01_ERROR_PLAY	<오류 발생!>	The text is in brackets because the VO files is just Annoy-o-Tron's greeting	
GAMEPLAY_EMOTE_HERO_TBMECHWAR01_ERROR_STEALTH	<오류 발생!>	The text is in brackets because the VO files is just Annoy-o-Tron's greeting	
GAMEPLAY_EMOTE_HERO_TBMECHWAR01_ERROR_TARGET	<오류 발생!>	The text is in brackets because the VO files is just Annoy-o-Tron's greeting	
GAMEPLAY_EMOTE_HERO_TBMECHWAR01_ERROR_TAUNT	<오류 발생!>	The text is in brackets because the VO files is just Annoy-o-Tron's greeting	
GAMEPLAY_EMOTE_HERO_TBMECHWAR01_GREETINGS	<안녕! 안녕! 안녕!>	The text is in brackets because the VO files is just Annoy-o-Tron's greeting	
GAMEPLAY_EMOTE_HERO_TBMECHWAR01_LOW_CARDS	<카드 부족>	The text is in brackets because the VO files is just Annoy-o-Tron's greeting	
GAMEPLAY_EMOTE_HERO_TBMECHWAR01_NO_CARDS	<카드 없음>	The text is in brackets because the VO files is just Annoy-o-Tron's greeting	
GAMEPLAY_EMOTE_HERO_TBMECHWAR01_OOPS	<오류 발생>	The text is in brackets because the VO files is just Annoy-o-Tron's greeting	
GAMEPLAY_EMOTE_HERO_TBMECHWAR01_SORRY	<사과>	The text is in brackets because the VO files is just Annoy-o-Tron's greeting	
GAMEPLAY_EMOTE_HERO_TBMECHWAR01_START	<시작>	The text is in brackets because the VO files is just Annoy-o-Tron's greeting	
GAMEPLAY_EMOTE_HERO_TBMECHWAR01_THANKS	<감사>	The text is in brackets because the VO files is just Annoy-o-Tron's greeting	
GAMEPLAY_EMOTE_HERO_TBMECHWAR01_THINK1	<데이터 처리 중...>	The text is in brackets because the VO files is just Annoy-o-Tron's greeting	
GAMEPLAY_EMOTE_HERO_TBMECHWAR01_THINK2	<대상 포착 중...>	The text is in brackets because the VO files is just Annoy-o-Tron's greeting	
GAMEPLAY_EMOTE_HERO_TBMECHWAR01_THINK3	<연산 중...>	The text is in brackets because the VO files is just Annoy-o-Tron's greeting	
GAMEPLAY_EMOTE_HERO_TBMECHWAR01_THREATEN	<위협>	The text is in brackets because the VO files is just Annoy-o-Tron's attack	
GAMEPLAY_EMOTE_HERO_TBMECHWAR01_TIMER	<시간 촉박>	The text is in brackets because the VO files is just Annoy-o-Tron's greeting	
GAMEPLAY_EMOTE_HERO_TBMECHWAR01_WELL_PLAYED	<칭찬>	The text is in brackets because the VO files is just Annoy-o-Tron's greeting	
GAMEPLAY_EMOTE_HERO_TBMECHWAR02_CONCEDE	<시스템 종료>	The text is in brackets because the VO files is just Boom Bot's greeting	
GAMEPLAY_EMOTE_HERO_TBMECHWAR02_ERROR_FULL_MINIONS	<오류 발생!>	The text is in brackets because the VO files is just Boom Bot's greeting	
GAMEPLAY_EMOTE_HERO_TBMECHWAR02_ERROR_HAND_FULL	<오류 발생!>	The text is in brackets because the VO files is just Boom Bot's greeting	
GAMEPLAY_EMOTE_HERO_TBMECHWAR02_ERROR_I_ATTACKED	<오류 발생!>	The text is in brackets because the VO files is just Boom Bot's greeting	
GAMEPLAY_EMOTE_HERO_TBMECHWAR02_ERROR_JUST_PLAYED	<오류 발생!>	The text is in brackets because the VO files is just Boom Bot's greeting	
GAMEPLAY_EMOTE_HERO_TBMECHWAR02_ERROR_MINION_ATTACKED	<오류 발생!>	The text is in brackets because the VO files is just Boom Bot's greeting	
GAMEPLAY_EMOTE_HERO_TBMECHWAR02_ERROR_NEED_MANA	<오류 발생!>	The text is in brackets because the VO files is just Boom Bot's greeting	
GAMEPLAY_EMOTE_HERO_TBMECHWAR02_ERROR_NEED_WEAPON	<오류 발생!>	The text is in brackets because the VO files is just Boom Bot's greeting	
GAMEPLAY_EMOTE_HERO_TBMECHWAR02_ERROR_PLAY	<오류 발생!>	The text is in brackets because the VO files is just Boom Bot's greeting	
GAMEPLAY_EMOTE_HERO_TBMECHWAR02_ERROR_STEALTH	<오류 발생!>	The text is in brackets because the VO files is just Boom Bot's greeting	
GAMEPLAY_EMOTE_HERO_TBMECHWAR02_ERROR_TARGET	<오류 발생!>	The text is in brackets because the VO files is just Boom Bot's greeting	
GAMEPLAY_EMOTE_HERO_TBMECHWAR02_ERROR_TAUNT	<오류 발생!>	The text is in brackets because the VO files is just Boom Bot's greeting	
GAMEPLAY_EMOTE_HERO_TBMECHWAR02_GREETINGS	<만나서 반가움>	The text is in brackets because the VO files is just Annoy-o-Tron's greeting	
GAMEPLAY_EMOTE_HERO_TBMECHWAR02_LOW_CARDS	<카드 부족>	The text is in brackets because the VO files is just Boom Bot's greeting	
GAMEPLAY_EMOTE_HERO_TBMECHWAR02_NO_CARDS	<카드 없음!>	The text is in brackets because the VO files is just Boom Bot's greeting	
GAMEPLAY_EMOTE_HERO_TBMECHWAR02_OOPS	<오류 발생!>	The text is in brackets because the VO files is just Boom Bot's greeting	
GAMEPLAY_EMOTE_HERO_TBMECHWAR02_SORRY	<사과>	The text is in brackets because the VO files is just Boom Bot's greeting	
GAMEPLAY_EMOTE_HERO_TBMECHWAR02_START	<가동 완료>	The text is in brackets because the VO files is just Boom Bot's greeting	
GAMEPLAY_EMOTE_HERO_TBMECHWAR02_THANKS	<감사>	The text is in brackets because the VO files is just Boom Bot's greeting	
GAMEPLAY_EMOTE_HERO_TBMECHWAR02_THINK1	<데이터 처리 중...>	The text is in brackets because the VO files is just Boom Bot's greeting	
GAMEPLAY_EMOTE_HERO_TBMECHWAR02_THINK2	<대상 포착 중...>	The text is in brackets because the VO files is just Boom Bot's greeting	
GAMEPLAY_EMOTE_HERO_TBMECHWAR02_THINK3	<연산 중...>	The text is in brackets because the VO files is just Boom Bot's greeting	
GAMEPLAY_EMOTE_HERO_TBMECHWAR02_THREATEN	<위협!>	The text is in brackets because the VO files is just Boom Bot's Attack sound	
GAMEPLAY_EMOTE_HERO_TBMECHWAR02_TIMER	<시간 촉박>	The text is in brackets because the VO files is just Boom Bot's greeting	
GAMEPLAY_EMOTE_HERO_TBMECHWAR02_WELL_PLAYED	<칭찬>	The text is in brackets because the VO files is just Boom Bot's greeting	
VO_BRM_027h__LUNAR_NEW_YEAR	화염 속에 새해를 맞이하라!		
VO_BRM_027h_Attack_15	설퍼론의 유황 맛을 보아라!		
VO_BRM_027h_Concede_11	네가 이겼노라! 잘했다!		
VO_BRM_027h_Emote_Start	복수의 시간이다, 용이여!		
VO_BRM_027h_ERROR01_51	무기가 필요하다!		
VO_BRM_027h_ERROR02_52	마나가 부족하다!		
VO_BRM_027h_ERROR03_53	그건 이미 공격했다.		
VO_BRM_027h_ERROR04_54	난 이미 공격했노라.		
VO_BRM_027h_ERROR05_55	그 필멸자는 다음 턴에 준비될 것이다.		
VO_BRM_027h_ERROR06_56	카드가 너무 많다!		
VO_BRM_027h_ERROR07_57	하수인이 너무 많군.		
VO_BRM_027h_ERROR08_58	그건 은신하고 있다!		
VO_BRM_027h_ERROR09_59	그건 낼 수 없노라.		
VO_BRM_027h_ERROR10_60	유효하지 않다.		
VO_BRM_027h_ERROR11_61	저 도발 하수인이 거슬린다!		
VO_BRM_027h_ERROR12_62	그럴 수 없다.		
VO_BRM_027h_GG_16	좋은 승부였다!		
VO_BRM_027h_Greetings_04	불의 세례를 받아라!		
VO_BRM_027h_HAPPY_NEW_YEAR_38	화염 속의 새해를 맞이하라!		
VO_BRM_027h_LowCards_49	카드를 거의 다 태워버렸다!		
VO_BRM_027h_NoCards_50	카드를 모두 태워버렸다!		
VO_BRM_027h_Oops_07	흥! 실수였다!		
VO_BRM_027h_Sorry_10	미안하다!		
VO_BRM_027h_Thanks_09	훈훈하군.		
VO_BRM_027h_Thinking1_12	흠...		
VO_BRM_027h_Thinking2_13	고민되는군...		
VO_BRM_027h_Thinking3_14	어느 놈부터 태워버릴까...		
VO_BRM_027h_Threaten_08	너희 모두 불꽃으로 스러지리라!		
VO_BRM_027h_Time_48	심지가 불타고 있다!		
VO_BRM_027h_Well_Played_06	훌륭하군!		
VO_BRM_027h_Winterveil_Greetings	이 계절은 좀 따뜻해질 필요가 있겠군!		
VO_TBA01_4__Concede	*으르렁*		
VO_TBA01_4__Error_Full_Minions	*으르렁*		
VO_TBA01_4__Error_Generic	*으르렁*		
VO_TBA01_4__Error_Hand_Full	*으르렁*		
VO_TBA01_4__Error_I_Attacked	*으르렁*		
VO_TBA01_4__Error_Just_Played	*으르렁*		
VO_TBA01_4__Error_Minion_Attacked	*으르렁*		
VO_TBA01_4__Error_Need_Mana	*으르렁*		
VO_TBA01_4__Error_Need_Weapon	*으르렁*		
VO_TBA01_4__Error_Play	*으르렁*		
VO_TBA01_4__Error_Stealth	*으르렁*		
VO_TBA01_4__Good_Game	*으르렁*		
VO_TBA01_4__Greetings	게임을 시작하자!		
VO_TBA01_4__Low_Cards	*으르렁*		
VO_TBA01_4__No_Cards	*으르렁*		
VO_TBA01_4__Oops	이런!		
VO_TBA01_4__Sorry	미안하다.		
VO_TBA01_4__Start	불타라! 활활!		
VO_TBA01_4__Thanks	고맙다.		
VO_TBA01_4__Threaten	하하하! 보아라! 이게 바로 나, 네파리안의 진정한 힘이다!		
VO_TBA01_4__Timer	*으르렁*		
VO_TBA01_4__Well_Played	잘했다.		
