TAG	TEXT	COMMENT	AUDIOFILE
GAMEPLAY_EMOTE_EX1_323h_CONCEDE	你赢了…但这个世界已经在劫难逃！！		
GAMEPLAY_EMOTE_EX1_323h_ERROR_FULL_MINIONS	随从太多了！		
GAMEPLAY_EMOTE_EX1_323h_ERROR_GENERIC	我不能\n这么做！		
GAMEPLAY_EMOTE_EX1_323h_ERROR_HAND_FULL	手牌太多了！		
GAMEPLAY_EMOTE_EX1_323h_ERROR_I_ATTACKED	我已经进行过攻击了。		
GAMEPLAY_EMOTE_EX1_323h_ERROR_JUST_PLAYED	它才刚刚\n被召唤出来！		
GAMEPLAY_EMOTE_EX1_323h_ERROR_MINION_ATTACKED	那个东西已经攻击过了。		
GAMEPLAY_EMOTE_EX1_323h_ERROR_NEED_MANA	法力值不足！		
GAMEPLAY_EMOTE_EX1_323h_ERROR_NEED_WEAPON	我的武器\n在哪儿？		
GAMEPLAY_EMOTE_EX1_323h_ERROR_PLAY	我不能\n使用那个。		
GAMEPLAY_EMOTE_EX1_323h_ERROR_STEALTH	它会潜行。		
GAMEPLAY_EMOTE_EX1_323h_ERROR_TARGET	不能这么做。		
GAMEPLAY_EMOTE_EX1_323h_ERROR_TAUNT	有个会嘲讽的随从挡着我了！		
GAMEPLAY_EMOTE_EX1_323h_GOOD_GAME	精彩的比赛！		
GAMEPLAY_EMOTE_EX1_323h_GREETINGS	面对加拉克苏斯吧，燃烧军团的艾瑞达之王！		
GAMEPLAY_EMOTE_EX1_323h_LOW_CARDS	我的套牌里\n剩下的卡牌\n不多了！		
GAMEPLAY_EMOTE_EX1_323h_LUNAR_NEW_YEAR	新年快乐！		
GAMEPLAY_EMOTE_EX1_323h_NO_CARDS	不！我已经\n没有卡牌了！		
GAMEPLAY_EMOTE_EX1_323h_OOPS	失误！		
GAMEPLAY_EMOTE_EX1_323h_SORRY	加拉克苏斯…\n很抱歉。		
GAMEPLAY_EMOTE_EX1_323h_THANKS	谢谢。		
GAMEPLAY_EMOTE_EX1_323h_THINK1	嗯...		
GAMEPLAY_EMOTE_EX1_323h_THINK2	我想….		
GAMEPLAY_EMOTE_EX1_323h_THINK3	我应该怎样\n把你摧毁呢…		
GAMEPLAY_EMOTE_EX1_323h_THREATEN	湮灭！！		
GAMEPLAY_EMOTE_EX1_323h_TIMER	快没有\n时间了！		
GAMEPLAY_EMOTE_EX1_323h_WELL_PLAYED	打得不错！		
GAMEPLAY_EMOTE_EX1_323h_WINTERVEIL_GREETINGS	我会在这个\n冬幕节夺去\n你们的灵魂！		
GAMEPLAY_EMOTE_EX1_323h_WOW_04	难以置信！		
GAMEPLAY_EMOTE_HERO_01_CONCEDE	我选择死亡！		
GAMEPLAY_EMOTE_HERO_01_ERROR_FULL_MINIONS	我无法再拥有更多随从了。		
GAMEPLAY_EMOTE_HERO_01_ERROR_GENERIC	我不能\n那么做。		
GAMEPLAY_EMOTE_HERO_01_ERROR_HAND_FULL	我的手牌\n满了！		
GAMEPLAY_EMOTE_HERO_01_ERROR_I_ATTACKED	我已经进行过攻击了。		
GAMEPLAY_EMOTE_HERO_01_ERROR_JUST_PLAYED	那个随从需要一个回合\n进行准备。		
GAMEPLAY_EMOTE_HERO_01_ERROR_MINION_ATTACKED	那个随从已经进行过\n攻击了。		
GAMEPLAY_EMOTE_HERO_01_ERROR_NEED_MANA	我没有足够的法力值。		
GAMEPLAY_EMOTE_HERO_01_ERROR_NEED_WEAPON	我需要\n一把武器。		
GAMEPLAY_EMOTE_HERO_01_ERROR_PLAY	我无法\n使用它。		
GAMEPLAY_EMOTE_HERO_01_ERROR_STEALTH	我无法将具有潜行技能的\n随从作为目标。		
GAMEPLAY_EMOTE_HERO_01_ERROR_TARGET	这不是一个\n有效的目标。		
GAMEPLAY_EMOTE_HERO_01_ERROR_TAUNT	我必须攻击\n那个具有嘲讽技能的随从。		
GAMEPLAY_EMOTE_HERO_01_EVENT_LUNAR_NEW_YEAR	给你拜年了。		
GAMEPLAY_EMOTE_HERO_01_GOOD_GAME	精彩的比赛。		
GAMEPLAY_EMOTE_HERO_01_GREETINGS	嗬，你好。		
GAMEPLAY_EMOTE_HERO_01_LOW_CARDS	我的卡牌就快要用光了！		
GAMEPLAY_EMOTE_HERO_01_MIRROR_START	哈哈！有种来啊！		
GAMEPLAY_EMOTE_HERO_01_NO_CARDS	我已经没有卡牌了！		
GAMEPLAY_EMOTE_HERO_01_OOPS	那真是个\n失误。		
GAMEPLAY_EMOTE_HERO_01_SORRY	发生这种事，我很抱歉。		
GAMEPLAY_EMOTE_HERO_01_START	不胜利，\n毋宁死！		
GAMEPLAY_EMOTE_HERO_01_THANKS	哼，谢谢。		
GAMEPLAY_EMOTE_HERO_01_THINK1	嗯...		
GAMEPLAY_EMOTE_HERO_01_THINK2	哼，我想….		
GAMEPLAY_EMOTE_HERO_01_THINK3	那么现在…		
GAMEPLAY_EMOTE_HERO_01_THREATEN	我要粉碎你！		
GAMEPLAY_EMOTE_HERO_01_TIMER	我要立刻\n作出决定！		
GAMEPLAY_EMOTE_HERO_01_WELL_PLAYED	打得不错。		
GAMEPLAY_EMOTE_HERO_01_WINTERVEIL_GREETINGS	冬幕节快乐！		
GAMEPLAY_EMOTE_HERO_01_WOW	真不错！		
GAMEPLAY_EMOTE_HERO_01A_CONCEDE	啊，\n你战胜了我。		
GAMEPLAY_EMOTE_HERO_01A_ERROR_FULL_MINIONS	我的随从\n太多了。		
GAMEPLAY_EMOTE_HERO_01A_ERROR_GENERIC	我不能\n那么做。		
GAMEPLAY_EMOTE_HERO_01A_ERROR_HAND_FULL	我的手牌\n已经满了！		
GAMEPLAY_EMOTE_HERO_01A_ERROR_I_ATTACKED	我已经\n攻击过了。		
GAMEPLAY_EMOTE_HERO_01A_ERROR_JUST_PLAYED	那个随从需要一个回合\n进行准备。		
GAMEPLAY_EMOTE_HERO_01A_ERROR_MINION_ATTACKED	那个随从已经攻击过了。		
GAMEPLAY_EMOTE_HERO_01A_ERROR_NEED_MANA	我没有足够的法力值。		
GAMEPLAY_EMOTE_HERO_01A_ERROR_NEED_WEAPON	我需要\n一把武器。		
GAMEPLAY_EMOTE_HERO_01A_ERROR_PLAY	我不能使用\n这张牌。		
GAMEPLAY_EMOTE_HERO_01A_ERROR_STEALTH	我不能以潜行的随从\n作为目标。		
GAMEPLAY_EMOTE_HERO_01A_ERROR_TARGET	那不是一个\n有效的目标。		
GAMEPLAY_EMOTE_HERO_01A_ERROR_TAUNT	我必须攻击\n那个具有嘲讽的随从。		
GAMEPLAY_EMOTE_HERO_01A_EVENT_LUNAR_NEW_YEAR	新年快乐。		
GAMEPLAY_EMOTE_HERO_01A_GOOD_GAME	精彩的比赛。		
GAMEPLAY_EMOTE_HERO_01A_GREETINGS	嘿，你好。		
GAMEPLAY_EMOTE_HERO_01A_LOW_CARDS	我快要\n没有牌了！		
GAMEPLAY_EMOTE_HERO_01A_MIRROR_START	是的，为了\n卡兹莫丹！		
GAMEPLAY_EMOTE_HERO_01A_NO_CARDS	我没有牌\n可以用了！		
GAMEPLAY_EMOTE_HERO_01A_OOPS	这好像……\n不太对。		
GAMEPLAY_EMOTE_HERO_01A_SORRY	我很抱歉，\n朋友。		
GAMEPLAY_EMOTE_HERO_01A_START	为了\n卡兹莫丹！		
GAMEPLAY_EMOTE_HERO_01A_THANKS	啊，谢谢你！		
GAMEPLAY_EMOTE_HERO_01A_THINK1	嗯……		
GAMEPLAY_EMOTE_HERO_01A_THINK2	用这张？\n不，不行……		
GAMEPLAY_EMOTE_HERO_01A_THINK3	这么多选择……		
GAMEPLAY_EMOTE_HERO_01A_THREATEN	感受山丘之王的愤怒！		
GAMEPLAY_EMOTE_HERO_01A_TIMER	啊，我得作出决定！		
GAMEPLAY_EMOTE_HERO_01A_WELL_PLAYED	打得很好。		
GAMEPLAY_EMOTE_HERO_01A_WINTERVEIL_GREETINGS	享受这冬幕节吧！		
GAMEPLAY_EMOTE_HERO_01A_WOW	以我胡子的名义，真的吗！		
GAMEPLAY_EMOTE_HERO_02_CONCEDE	这局你赢了，朋友。		
GAMEPLAY_EMOTE_HERO_02_ERROR_FULL_MINIONS	我无法再拥有更多随从了。		
GAMEPLAY_EMOTE_HERO_02_ERROR_GENERIC	我无法\n这么做。		
GAMEPLAY_EMOTE_HERO_02_ERROR_HAND_FULL	我的手牌\n已经满了！		
GAMEPLAY_EMOTE_HERO_02_ERROR_I_ATTACKED	我已经进行过攻击了！		
GAMEPLAY_EMOTE_HERO_02_ERROR_JUST_PLAYED	那个随从需要一个回合\n进行准备。		
GAMEPLAY_EMOTE_HERO_02_ERROR_MINION_ATTACKED	那个随从已经进行过\n攻击了。		
GAMEPLAY_EMOTE_HERO_02_ERROR_NEED_MANA	我没有足够的法力值。		
GAMEPLAY_EMOTE_HERO_02_ERROR_NEED_WEAPON	我需要\n一把武器。		
GAMEPLAY_EMOTE_HERO_02_ERROR_PLAY	我无法\n使用它。		
GAMEPLAY_EMOTE_HERO_02_ERROR_STEALTH	我无法将具有潜行技能的\n随从作为目标。		
GAMEPLAY_EMOTE_HERO_02_ERROR_TARGET	这不是一个\n有效的目标。		
GAMEPLAY_EMOTE_HERO_02_ERROR_TAUNT	我必须攻击\n那个具有嘲讽技能的随从。		
GAMEPLAY_EMOTE_HERO_02_EVENT_LUNAR_NEW_YEAR	给你拜年了。		
GAMEPLAY_EMOTE_HERO_02_GOOD_GAME	精彩的比赛。		
GAMEPLAY_EMOTE_HERO_02_GREETINGS	你好，朋友。		
GAMEPLAY_EMOTE_HERO_02_LOW_CARDS	我的卡牌就快要用光了！		
GAMEPLAY_EMOTE_HERO_02_MIRROR_START	为了霜狼氏族！		
GAMEPLAY_EMOTE_HERO_02_NO_CARDS	我已经没有\n卡牌了！		
GAMEPLAY_EMOTE_HERO_02_OOPS	我犯了个\n错误。		
GAMEPLAY_EMOTE_HERO_02_SORRY	真是抱歉。		
GAMEPLAY_EMOTE_HERO_02_START	为了\n毁灭之锤！		
GAMEPLAY_EMOTE_HERO_02_THANKS	我对你\n非常感谢。		
GAMEPLAY_EMOTE_HERO_02_THINK1	嗯...		
GAMEPLAY_EMOTE_HERO_02_THINK2	我想….		
GAMEPLAY_EMOTE_HERO_02_THINK3	怎么办呢…		
GAMEPLAY_EMOTE_HERO_02_THREATEN	元素之力\n会毁灭你！		
GAMEPLAY_EMOTE_HERO_02_TIMER	时间不多了！		
GAMEPLAY_EMOTE_HERO_02_WELL_PLAYED	打得不错。		
GAMEPLAY_EMOTE_HERO_02_WINTERVEIL_GREETINGS	冬幕节快乐！		
GAMEPLAY_EMOTE_HERO_02_WOW	难以置信！		
GAMEPLAY_EMOTE_HERO_03_CONCEDE	我输了。		
GAMEPLAY_EMOTE_HERO_03_ERROR_FULL_MINIONS	我无法再拥有更多随从了。		
GAMEPLAY_EMOTE_HERO_03_ERROR_GENERIC	我无法\n这么做。		
GAMEPLAY_EMOTE_HERO_03_ERROR_HAND_FULL	我的手牌\n已经满了！		
GAMEPLAY_EMOTE_HERO_03_ERROR_I_ATTACKED	我已经进行过攻击了。		
GAMEPLAY_EMOTE_HERO_03_ERROR_JUST_PLAYED	那个随从需要一个回合\n进行准备。		
GAMEPLAY_EMOTE_HERO_03_ERROR_MINION_ATTACKED	那个随从已经进行过\n攻击了。		
GAMEPLAY_EMOTE_HERO_03_ERROR_NEED_MANA	我没有足够的法力值。		
GAMEPLAY_EMOTE_HERO_03_ERROR_NEED_WEAPON	我需要\n一把武器。		
GAMEPLAY_EMOTE_HERO_03_ERROR_PLAY	我无法\n使用它。		
GAMEPLAY_EMOTE_HERO_03_ERROR_STEALTH	我无法将具有潜行技能的\n随从作为目标。		
GAMEPLAY_EMOTE_HERO_03_ERROR_TARGET	这不是一个\n有效的目标。		
GAMEPLAY_EMOTE_HERO_03_ERROR_TAUNT	我必须攻击\n那个具有嘲讽技能的随从。		
GAMEPLAY_EMOTE_HERO_03_EVENT_LUNAR_NEW_YEAR	新年好。		
GAMEPLAY_EMOTE_HERO_03_GOOD_GAME	精彩的比赛。		
GAMEPLAY_EMOTE_HERO_03_GREETINGS	很荣幸\n见到你。		
GAMEPLAY_EMOTE_HERO_03_LOW_CARDS	我的卡牌就快要用光了。		
GAMEPLAY_EMOTE_HERO_03_MIRROR_START	不用你提醒我。		
GAMEPLAY_EMOTE_HERO_03_NO_CARDS	我已经没有\n卡牌了！		
GAMEPLAY_EMOTE_HERO_03_OOPS	我犯了个\n错误。		
GAMEPLAY_EMOTE_HERO_03_SORRY	对此我很\n抱歉。		
GAMEPLAY_EMOTE_HERO_03_START	当心你的\n背后。		
GAMEPLAY_EMOTE_HERO_03_THANKS	谢谢你。		
GAMEPLAY_EMOTE_HERO_03_THINK1	嗯...		
GAMEPLAY_EMOTE_HERO_03_THINK2	我想...		
GAMEPLAY_EMOTE_HERO_03_THINK3	选择很多...		
GAMEPLAY_EMOTE_HERO_03_THREATEN	你\n死到临头了！		
GAMEPLAY_EMOTE_HERO_03_TIMER	我得快点\n做出决定！		
GAMEPLAY_EMOTE_HERO_03_WELL_PLAYED	打得不错。		
GAMEPLAY_EMOTE_HERO_03_WINTERVEIL_GREETINGS	冬幕节快乐。		
GAMEPLAY_EMOTE_HERO_03_WOW	天呐。		
GAMEPLAY_EMOTE_HERO_04_CONCEDE	胜利属于你。		
GAMEPLAY_EMOTE_HERO_04_ERROR_FULL_MINIONS	我无法再拥有更多随从了。		
GAMEPLAY_EMOTE_HERO_04_ERROR_GENERIC	我无法\n这么做。		
GAMEPLAY_EMOTE_HERO_04_ERROR_HAND_FULL	我的手牌\n已经满了！		
GAMEPLAY_EMOTE_HERO_04_ERROR_I_ATTACKED	我已经进行过攻击了。		
GAMEPLAY_EMOTE_HERO_04_ERROR_JUST_PLAYED	那个随从需要一个回合\n进行准备。		
GAMEPLAY_EMOTE_HERO_04_ERROR_MINION_ATTACKED	那个随从已经进行过\n攻击了。		
GAMEPLAY_EMOTE_HERO_04_ERROR_NEED_MANA	我没有足够的法力值。		
GAMEPLAY_EMOTE_HERO_04_ERROR_NEED_WEAPON	我需要\n一把武器。		
GAMEPLAY_EMOTE_HERO_04_ERROR_PLAY	我无法\n使用它。		
GAMEPLAY_EMOTE_HERO_04_ERROR_STEALTH	我无法将具有潜行技能的\n随从作为目标。		
GAMEPLAY_EMOTE_HERO_04_ERROR_TARGET	这不是一个\n有效的目标。		
GAMEPLAY_EMOTE_HERO_04_ERROR_TAUNT	我必须攻击\n那个具有嘲讽技能的随从。		
GAMEPLAY_EMOTE_HERO_04_EVENT_LUNAR_NEW_YEAR	新年快乐！		
GAMEPLAY_EMOTE_HERO_04_GOOD_GAME	精彩的比赛。		
GAMEPLAY_EMOTE_HERO_04_GREETINGS	很高兴\n见到你！		
GAMEPLAY_EMOTE_HERO_04_LOW_CARDS	我的卡牌就快要用光了！		
GAMEPLAY_EMOTE_HERO_04_MIRROR_START	圣光就是我的利刃！		
GAMEPLAY_EMOTE_HERO_04_NO_CARDS	我已经没有\n卡牌了！		
GAMEPLAY_EMOTE_HERO_04_OOPS	真是失误。		
GAMEPLAY_EMOTE_HERO_04_SORRY	我很抱歉。		
GAMEPLAY_EMOTE_HERO_04_START	荣耀赐予我\n力量！		
GAMEPLAY_EMOTE_HERO_04_THANKS	谢谢你。		
GAMEPLAY_EMOTE_HERO_04_THINK1	嗯...		
GAMEPLAY_EMOTE_HERO_04_THINK2	我想….		
GAMEPLAY_EMOTE_HERO_04_THINK3	让我想想…		
GAMEPLAY_EMOTE_HERO_04_THREATEN	接受正义的\n制裁吧！		
GAMEPLAY_EMOTE_HERO_04_TIMER	我必须\n立即行动！		
GAMEPLAY_EMOTE_HERO_04_WELL_PLAYED	打得不错。		
GAMEPLAY_EMOTE_HERO_04_WINTERVEIL_GREETINGS	冬幕节快乐，勇士！		
GAMEPLAY_EMOTE_HERO_04_WOW	我的圣光啊！		
GAMEPLAY_EMOTE_HERO_04A_CONCEDE	朋友，你赢了。我认输。		
GAMEPLAY_EMOTE_HERO_04A_ERROR_FULL_MINIONS	我已经拥有太多的随从。		
GAMEPLAY_EMOTE_HERO_04A_ERROR_GENERIC	我不能这么做。		
GAMEPLAY_EMOTE_HERO_04A_ERROR_HAND_FULL	我的手牌满了！		
GAMEPLAY_EMOTE_HERO_04A_ERROR_I_ATTACKED	我已经攻击过了。		
GAMEPLAY_EMOTE_HERO_04A_ERROR_JUST_PLAYED	给那个随从一个回合的准备时间。		
GAMEPLAY_EMOTE_HERO_04A_ERROR_MINION_ATTACKED	那个随从已经攻击过了。		
GAMEPLAY_EMOTE_HERO_04A_ERROR_NEED_MANA	我没有足够的法力值。		
GAMEPLAY_EMOTE_HERO_04A_ERROR_NEED_WEAPON	我需要一把武器。		
GAMEPLAY_EMOTE_HERO_04A_ERROR_PLAY	我不能使用这张牌。		
GAMEPLAY_EMOTE_HERO_04A_ERROR_STEALTH	我不能以潜行的随从作为目标。		
GAMEPLAY_EMOTE_HERO_04A_ERROR_TARGET	这不是一个合理的目标。		
GAMEPLAY_EMOTE_HERO_04A_ERROR_TAUNT	我必须攻击那个具有嘲讽的随从。		
GAMEPLAY_EMOTE_HERO_04A_GOOD_GAME	精彩的比赛。		
GAMEPLAY_EMOTE_HERO_04A_GREETINGS	啊，你好，挑战者。		
GAMEPLAY_EMOTE_HERO_04A_LOW_CARDS	我就快没牌了！		
GAMEPLAY_EMOTE_HERO_04A_LUNAR_NEW_YEAR	新年快乐！		
GAMEPLAY_EMOTE_HERO_04A_MIRROR_START	神圣之火，\n永不熄灭。		
GAMEPLAY_EMOTE_HERO_04A_NO_CARDS	我没有牌了！		
GAMEPLAY_EMOTE_HERO_04A_OOPS	这确实是个错误。		
GAMEPLAY_EMOTE_HERO_04A_SORRY	啊，向你致歉。		
GAMEPLAY_EMOTE_HERO_04A_START	神圣之火燃烧着我的战锤！		
GAMEPLAY_EMOTE_HERO_04A_THANKS	我由衷地感谢你。		
GAMEPLAY_EMOTE_HERO_04A_THINK1	嗯……		
GAMEPLAY_EMOTE_HERO_04A_THINK2	这样，或者这样……		
GAMEPLAY_EMOTE_HERO_04A_THINK3	我是不是应该……		
GAMEPLAY_EMOTE_HERO_04A_THREATEN	你将付出代价，败类！		
GAMEPLAY_EMOTE_HERO_04A_TIMER	行动起来！		
GAMEPLAY_EMOTE_HERO_04A_WELL_PLAYED	打的不错。		
GAMEPLAY_EMOTE_HERO_04A_WINTERVEIL_GREETINGS	享受这冬幕节吧！		
GAMEPLAY_EMOTE_HERO_04A_WOW	这简直难以置信！		
GAMEPLAY_EMOTE_HERO_05_CONCEDE	打得好，\n我认输。		
GAMEPLAY_EMOTE_HERO_05_ERROR_FULL_MINIONS	我无法再拥有更多随从了。		
GAMEPLAY_EMOTE_HERO_05_ERROR_GENERIC	我无法\n这么做。		
GAMEPLAY_EMOTE_HERO_05_ERROR_HAND_FULL	我的手牌\n已经满了！		
GAMEPLAY_EMOTE_HERO_05_ERROR_I_ATTACKED	我已经进行过攻击了。		
GAMEPLAY_EMOTE_HERO_05_ERROR_JUST_PLAYED	那个随从需要一个回合\n进行准备。		
GAMEPLAY_EMOTE_HERO_05_ERROR_MINION_ATTACKED	那个随从已经进行过\n攻击了。		
GAMEPLAY_EMOTE_HERO_05_ERROR_NEED_MANA	我没有足够的法力值。		
GAMEPLAY_EMOTE_HERO_05_ERROR_NEED_WEAPON	我需要\n一把武器。		
GAMEPLAY_EMOTE_HERO_05_ERROR_PLAY	我无法\n使用它。		
GAMEPLAY_EMOTE_HERO_05_ERROR_STEALTH	我无法将具有潜行技能的\n随从作为目标。		
GAMEPLAY_EMOTE_HERO_05_ERROR_TARGET	这不是一个\n有效的目标。		
GAMEPLAY_EMOTE_HERO_05_ERROR_TAUNT	我必须攻击\n那个具有嘲讽技能的随从。		
GAMEPLAY_EMOTE_HERO_05_EVENT_LUNAR_NEW_YEAR	新年\n狩猎愉快。		
GAMEPLAY_EMOTE_HERO_05_GOOD_GAME	精彩的比赛。		
GAMEPLAY_EMOTE_HERO_05_GREETINGS	你好，\n旅行者。		
GAMEPLAY_EMOTE_HERO_05_LOW_CARDS	我的卡牌就快要用光了！		
GAMEPLAY_EMOTE_HERO_05_MIRROR_START	看谁笑到最后！		
GAMEPLAY_EMOTE_HERO_05_NO_CARDS	我已经没有\n卡牌了！		
GAMEPLAY_EMOTE_HERO_05_OOPS	这不是我想要的结果。		
GAMEPLAY_EMOTE_HERO_05_SORRY	抱歉。		
GAMEPLAY_EMOTE_HERO_05_START	狩猎开始了！		
GAMEPLAY_EMOTE_HERO_05_THANKS	谢谢。		
GAMEPLAY_EMOTE_HERO_05_THINK1	嗯...		
GAMEPLAY_EMOTE_HERO_05_THINK2	我想….		
GAMEPLAY_EMOTE_HERO_05_THINK3	嗯...		
GAMEPLAY_EMOTE_HERO_05_THREATEN	你将成为\n我的猎物！		
GAMEPLAY_EMOTE_HERO_05_TIMER	时间过得\n很快！		
GAMEPLAY_EMOTE_HERO_05_WELL_PLAYED	打得不错。		
GAMEPLAY_EMOTE_HERO_05_WINTERVEIL_GREETINGS	冬幕节快乐！		
GAMEPLAY_EMOTE_HERO_05_WOW	真厉害！		
GAMEPLAY_EMOTE_HERO_05A_CONCEDE	你技高一筹，\n我认输！		
GAMEPLAY_EMOTE_HERO_05A_ERROR_FULL_MINIONS	我已经拥有了太多的随从。		
GAMEPLAY_EMOTE_HERO_05A_ERROR_GENERIC	我不能\n这么做。		
GAMEPLAY_EMOTE_HERO_05A_ERROR_HAND_FULL	我的手牌\n满了！		
GAMEPLAY_EMOTE_HERO_05A_ERROR_I_ATTACKED	我已经\n攻击过了。		
GAMEPLAY_EMOTE_HERO_05A_ERROR_JUST_PLAYED	给那个随从\n一个回合的\n准备时间。		
GAMEPLAY_EMOTE_HERO_05A_ERROR_MINION_ATTACKED	那个随从已经攻击过了。		
GAMEPLAY_EMOTE_HERO_05A_ERROR_NEED_MANA	我没有足够的法力值。		
GAMEPLAY_EMOTE_HERO_05A_ERROR_NEED_WEAPON	我需要\n一把武器。		
GAMEPLAY_EMOTE_HERO_05A_ERROR_PLAY	我不能使用\n这张牌。		
GAMEPLAY_EMOTE_HERO_05A_ERROR_STEALTH	我不能以\n潜行的随从\n作为目标。		
GAMEPLAY_EMOTE_HERO_05A_ERROR_TARGET	这不是一个\n合理的目标。		
GAMEPLAY_EMOTE_HERO_05A_ERROR_TAUNT	我必须攻击\n那个具有嘲讽的随从。		
GAMEPLAY_EMOTE_HERO_05A_EVENT_LUNAR_NEW_YEAR	新年快乐。		
GAMEPLAY_EMOTE_HERO_05A_GOOD_GAME	精彩的比赛。		
GAMEPLAY_EMOTE_HERO_05A_GREETINGS	你好，\n旅行者。		
GAMEPLAY_EMOTE_HERO_05A_LOW_CARDS	我就快\n没牌了！		
GAMEPLAY_EMOTE_HERO_05A_MIRROR_START	我从不颤抖。		
GAMEPLAY_EMOTE_HERO_05A_NO_CARDS	我没有牌了！		
GAMEPLAY_EMOTE_HERO_05A_OOPS	嗯，犯了个\n错误。		
GAMEPLAY_EMOTE_HERO_05A_SORRY	我很抱歉。		
GAMEPLAY_EMOTE_HERO_05A_START	在精灵的力量面前颤抖吧！		
GAMEPLAY_EMOTE_HERO_05A_THANKS	谢谢。		
GAMEPLAY_EMOTE_HERO_05A_THINK1	嗯……		
GAMEPLAY_EMOTE_HERO_05A_THINK2	射死\n哪一个呢？		
GAMEPLAY_EMOTE_HERO_05A_THINK3	该怎么做呢？		
GAMEPLAY_EMOTE_HERO_05A_THREATEN	我很快就会\n报仇的！		
GAMEPLAY_EMOTE_HERO_05A_TIMER	快做出决定！		
GAMEPLAY_EMOTE_HERO_05A_WELL_PLAYED	打得不错。		
GAMEPLAY_EMOTE_HERO_05A_WINTERVEIL_GREETING	冬幕节愉快。		
GAMEPLAY_EMOTE_HERO_05A_WOW	难以置信！		
GAMEPLAY_EMOTE_HERO_06_CONCEDE	我承认，\n你赢了。		
GAMEPLAY_EMOTE_HERO_06_ERROR_FULL_MINIONS	我无法再拥有更多随从了。		
GAMEPLAY_EMOTE_HERO_06_ERROR_GENERIC	我无法\n这么做。		
GAMEPLAY_EMOTE_HERO_06_ERROR_HAND_FULL	我的手牌\n已经满了。		
GAMEPLAY_EMOTE_HERO_06_ERROR_I_ATTACKED	我已经进行过攻击了。		
GAMEPLAY_EMOTE_HERO_06_ERROR_JUST_PLAYED	那个随从需要一个回合\n进行准备。		
GAMEPLAY_EMOTE_HERO_06_ERROR_MINION_ATTACKED	那个随从已经进行过\n攻击了。		
GAMEPLAY_EMOTE_HERO_06_ERROR_NEED_MANA	我没有足够的法力值。		
GAMEPLAY_EMOTE_HERO_06_ERROR_NEED_WEAPON	我需要\n一把武器。		
GAMEPLAY_EMOTE_HERO_06_ERROR_PLAY	我无法\n使用它。		
GAMEPLAY_EMOTE_HERO_06_ERROR_STEALTH	我无法将具有潜行技能的\n随从作为目标。		
GAMEPLAY_EMOTE_HERO_06_ERROR_TARGET	这不是一个\n有效的目标。		
GAMEPLAY_EMOTE_HERO_06_ERROR_TAUNT	我必须攻击\n那个具有嘲讽技能的随从。		
GAMEPLAY_EMOTE_HERO_06_EVENT_LUNAR_NEW_YEAR	新年好。		
GAMEPLAY_EMOTE_HERO_06_GOOD_GAME	精彩的比赛。		
GAMEPLAY_EMOTE_HERO_06_GREETINGS	欢迎。		
GAMEPLAY_EMOTE_HERO_06_LOW_CARDS	我的卡牌就快要用完了。		
GAMEPLAY_EMOTE_HERO_06_MIRROR_START	谨遵大自然的教诲！		
GAMEPLAY_EMOTE_HERO_06_NO_CARDS	我已经没有\n卡牌了。		
GAMEPLAY_EMOTE_HERO_06_OOPS	很自然的\n错误…		
GAMEPLAY_EMOTE_HERO_06_SORRY	对此我很\n抱歉。		
GAMEPLAY_EMOTE_HERO_06_START	我是大自然的守护者。		
GAMEPLAY_EMOTE_HERO_06_THANKS	谢谢你。		
GAMEPLAY_EMOTE_HERO_06_THINK1	嗯...		
GAMEPLAY_EMOTE_HERO_06_THINK2	嗯...我想….		
GAMEPLAY_EMOTE_HERO_06_THINK3	应该如何\n应对...		
GAMEPLAY_EMOTE_HERO_06_THREATEN	你无法抵挡\n大自然的\n力量！		
GAMEPLAY_EMOTE_HERO_06_TIMER	时间不等人…		
GAMEPLAY_EMOTE_HERO_06_WELL_PLAYED	嗯，\n打得不错。		
GAMEPLAY_EMOTE_HERO_06_WINTERVEIL_GREETINGS	冬幕节快乐。		
GAMEPLAY_EMOTE_HERO_06_WOW	真是壮观！		
GAMEPLAY_EMOTE_HERO_07_CONCEDE	这次是你\n赢了…		
GAMEPLAY_EMOTE_HERO_07_ERROR_FULL_MINIONS	我无法再拥有更多随从了。		
GAMEPLAY_EMOTE_HERO_07_ERROR_GENERIC	我无法\n这么做。		
GAMEPLAY_EMOTE_HERO_07_ERROR_HAND_FULL	我的手牌\n已经满了。		
GAMEPLAY_EMOTE_HERO_07_ERROR_I_ATTACKED	我已经进行过攻击了。		
GAMEPLAY_EMOTE_HERO_07_ERROR_JUST_PLAYED	那个随从需要一个回合\n进行准备。		
GAMEPLAY_EMOTE_HERO_07_ERROR_MINION_ATTACKED	那个随从已经进行过\n攻击了。		
GAMEPLAY_EMOTE_HERO_07_ERROR_NEED_MANA	我没有足够的法力值。		
GAMEPLAY_EMOTE_HERO_07_ERROR_NEED_WEAPON	我需要\n一把武器。		
GAMEPLAY_EMOTE_HERO_07_ERROR_PLAY	我无法\n使用它。		
GAMEPLAY_EMOTE_HERO_07_ERROR_STEALTH	我无法将具有潜行技能的随从作为目标。		
GAMEPLAY_EMOTE_HERO_07_ERROR_TARGET	这不是一个\n有效的目标。		
GAMEPLAY_EMOTE_HERO_07_ERROR_TAUNT	我必须攻击\n那个具有嘲讽技能的随从。		
GAMEPLAY_EMOTE_HERO_07_EVENT_LUNAR_NEW_YEAR	给你拜年了。		
GAMEPLAY_EMOTE_HERO_07_GOOD_GAME	精彩的比赛。		
GAMEPLAY_EMOTE_HERO_07_GREETINGS	你好。		
GAMEPLAY_EMOTE_HERO_07_LOW_CARDS	我的卡牌就快要用光了。		
GAMEPLAY_EMOTE_HERO_07_MIRROR_START	我将成为你的梦魇！		
GAMEPLAY_EMOTE_HERO_07_NO_CARDS	我已经没有\n卡牌了。		
GAMEPLAY_EMOTE_HERO_07_OOPS	那是个错误。		
GAMEPLAY_EMOTE_HERO_07_SORRY	抱歉。		
GAMEPLAY_EMOTE_HERO_07_START	我会夺取\n你的灵魂！		
GAMEPLAY_EMOTE_HERO_07_THANKS	谢谢你。		
GAMEPLAY_EMOTE_HERO_07_THINK1	嗯...		
GAMEPLAY_EMOTE_HERO_07_THINK2	我想….		
GAMEPLAY_EMOTE_HERO_07_THINK3	如此多的\n可能性… 		
GAMEPLAY_EMOTE_HERO_07_THREATEN	你的灵魂\n将受到折磨！		
GAMEPLAY_EMOTE_HERO_07_TIMER	我快没有\n时间了！		
GAMEPLAY_EMOTE_HERO_07_WELL_PLAYED	打得不错。		
GAMEPLAY_EMOTE_HERO_07_WINTERVEIL_GREETINGS	冬幕节快乐…		
GAMEPLAY_EMOTE_HERO_07_WOW	很不错。		
GAMEPLAY_EMOTE_HERO_08_CONCEDE	你赢了。		
GAMEPLAY_EMOTE_HERO_08_ERROR_FULL_MINIONS	我无法再拥有更多随从了。		
GAMEPLAY_EMOTE_HERO_08_ERROR_GENERIC	我无法\n这么做。		
GAMEPLAY_EMOTE_HERO_08_ERROR_HAND_FULL	我的手牌\n已经满了。		
GAMEPLAY_EMOTE_HERO_08_ERROR_I_ATTACKED	我已经进行过攻击了。		
GAMEPLAY_EMOTE_HERO_08_ERROR_JUST_PLAYED	那个随从需要一个回合\n进行准备。		
GAMEPLAY_EMOTE_HERO_08_ERROR_MINION_ATTACKED	那个随从已经进行过\n攻击了。		
GAMEPLAY_EMOTE_HERO_08_ERROR_NEED_MANA	我没有足够的法力值。		
GAMEPLAY_EMOTE_HERO_08_ERROR_NEED_WEAPON	我需要\n一把武器。		
GAMEPLAY_EMOTE_HERO_08_ERROR_PLAY	我无法\n使用它。		
GAMEPLAY_EMOTE_HERO_08_ERROR_STEALTH	我无法将具有潜行技能的\n随从作为目标。		
GAMEPLAY_EMOTE_HERO_08_ERROR_TARGET	这不是一个\n有效的目标。		
GAMEPLAY_EMOTE_HERO_08_ERROR_TAUNT	我必须攻击\n那个具有嘲讽技能的随从。		
GAMEPLAY_EMOTE_HERO_08_EVENT_LUNAR_NEW_YEAR	新年快乐。		
GAMEPLAY_EMOTE_HERO_08_GOOD_GAME	精彩的比赛。		
GAMEPLAY_EMOTE_HERO_08_GREETINGS	你好。		
GAMEPLAY_EMOTE_HERO_08_LOW_CARDS	我的卡牌就快要用光了！		
GAMEPLAY_EMOTE_HERO_08_MIRROR_START	那就来吧。		
GAMEPLAY_EMOTE_HERO_08_NO_CARDS	我已经没有\n卡牌了！		
GAMEPLAY_EMOTE_HERO_08_OOPS	哦，糟了。		
GAMEPLAY_EMOTE_HERO_08_SORRY	抱歉。		
GAMEPLAY_EMOTE_HERO_08_START	这可是你\n自找的！		
GAMEPLAY_EMOTE_HERO_08_THANKS	谢谢你。		
GAMEPLAY_EMOTE_HERO_08_THINK1	嗯...		
GAMEPLAY_EMOTE_HERO_08_THINK2	我想….		
GAMEPLAY_EMOTE_HERO_08_THINK3	该怎么办呢，怎么办呢…		
GAMEPLAY_EMOTE_HERO_08_THREATEN	我的魔法会把你撕成碎片！		
GAMEPLAY_EMOTE_HERO_08_TIMER	我没有\n时间了…		
GAMEPLAY_EMOTE_HERO_08_WELL_PLAYED	打得不错。		
GAMEPLAY_EMOTE_HERO_08_WINTERVEIL_GREETINGS	冬幕节快乐！		
GAMEPLAY_EMOTE_HERO_08_WOW	太棒了。		
GAMEPLAY_EMOTE_HERO_08A_CONCEDE	这是步好棋！我认输。		
GAMEPLAY_EMOTE_HERO_08A_ERROR_FULL_MINIONS	我召唤了太多的随从！		
GAMEPLAY_EMOTE_HERO_08A_ERROR_GENERIC	我不能\n这么做。		
GAMEPLAY_EMOTE_HERO_08A_ERROR_HAND_FULL	我的手牌\n满了！		
GAMEPLAY_EMOTE_HERO_08A_ERROR_I_ATTACKED	我已经\n攻击过了。		
GAMEPLAY_EMOTE_HERO_08A_ERROR_JUST_PLAYED	给那个随从\n一个回合的\n准备时间。		
GAMEPLAY_EMOTE_HERO_08A_ERROR_MINION_ATTACKED	那个随从已经攻击过了。		
GAMEPLAY_EMOTE_HERO_08A_ERROR_NEED_MANA	我没有足够的法力值。		
GAMEPLAY_EMOTE_HERO_08A_ERROR_NEED_WEAPON	我需要\n一把武器。		
GAMEPLAY_EMOTE_HERO_08A_ERROR_PLAY	我不能使用\n这张牌。		
GAMEPLAY_EMOTE_HERO_08A_ERROR_STEALTH	我不能\n以潜行的随从作为目标。		
GAMEPLAY_EMOTE_HERO_08A_ERROR_TARGET	这不是一个\n合理的目标。		
GAMEPLAY_EMOTE_HERO_08A_ERROR_TAUNT	我必须攻击\n那个具有嘲讽的随从。		
GAMEPLAY_EMOTE_HERO_08A_GOOD_GAME	精彩的比赛。		
GAMEPLAY_EMOTE_HERO_08A_GREETINGS	啊，你好。		
GAMEPLAY_EMOTE_HERO_08A_LOW_CARDS	我快要\n无牌可用了！		
GAMEPLAY_EMOTE_HERO_08A_LUNAR_NEW_YEAR	新年快乐。		
GAMEPLAY_EMOTE_HERO_08A_MIRROR_START	哦，比赛已经开始了。		
GAMEPLAY_EMOTE_HERO_08A_NO_CARDS	我没有牌了！		
GAMEPLAY_EMOTE_HERO_08A_OOPS	那可真蠢。		
GAMEPLAY_EMOTE_HERO_08A_SORRY	我表示由衷的歉意。		
GAMEPLAY_EMOTE_HERO_08A_START	就让比赛\n开始吧。		
GAMEPLAY_EMOTE_HERO_08A_THANKS	我很感激。		
GAMEPLAY_EMOTE_HERO_08A_THINK1	嗯……		
GAMEPLAY_EMOTE_HERO_08A_THINK2	有意思……		
GAMEPLAY_EMOTE_HERO_08A_THINK3	也许……		
GAMEPLAY_EMOTE_HERO_08A_THREATEN	没有什么能够阻止我！\n没有！		
GAMEPLAY_EMOTE_HERO_08A_TIMER	不能再\n碌碌无为了！		
GAMEPLAY_EMOTE_HERO_08A_WELL_PLAYED	打得不错。		
GAMEPLAY_EMOTE_HERO_08A_WINTERVEIL_GREETINGS	节日快乐，挑战者。		
GAMEPLAY_EMOTE_HERO_08A_WOW	喔，难以置信。		
GAMEPLAY_EMOTE_HERO_08B_CONCEDE	很出色，你赢了。		
GAMEPLAY_EMOTE_HERO_08B_ERROR_FULL_MINIONS	我已经拥有了太多的随从。		
GAMEPLAY_EMOTE_HERO_08B_ERROR_GENERIC	我不能\n这么做。		
GAMEPLAY_EMOTE_HERO_08B_ERROR_HAND_FULL	我的手牌\n已经满了！		
GAMEPLAY_EMOTE_HERO_08B_ERROR_I_ATTACKED	我已经\n攻击过了。		
GAMEPLAY_EMOTE_HERO_08B_ERROR_JUST_PLAYED	那个随从需要一个回合\n进行准备。		
GAMEPLAY_EMOTE_HERO_08B_ERROR_MINION_ATTACKED	那个随从已经攻击过了。		
GAMEPLAY_EMOTE_HERO_08B_ERROR_NEED_MANA	我没有足够的法力值。		
GAMEPLAY_EMOTE_HERO_08B_ERROR_NEED_WEAPON	我需要\n一把武器。		
GAMEPLAY_EMOTE_HERO_08B_ERROR_PLAY	我不能使用\n这张牌。		
GAMEPLAY_EMOTE_HERO_08B_ERROR_STEALTH	我不能以潜行的随从作为目标。		
GAMEPLAY_EMOTE_HERO_08B_ERROR_TARGET	那不是一个\n有效的目标。		
GAMEPLAY_EMOTE_HERO_08B_ERROR_TAUNT	必须先攻击\n具有嘲讽的\n随从。		
GAMEPLAY_EMOTE_HERO_08B_GOOD_GAME	很好，真是棋逢对手！		
GAMEPLAY_EMOTE_HERO_08B_GREETINGS	你好，求知者。		
GAMEPLAY_EMOTE_HERO_08B_LOW_CARDS	我快要\n没有牌了。		
GAMEPLAY_EMOTE_HERO_08B_LUNAR_NEW_YEAR	新年快乐！		
GAMEPLAY_EMOTE_HERO_08B_MIRROR_START	愿我们一起共同成长。		
GAMEPLAY_EMOTE_HERO_08B_NO_CARDS	我已经没有\n卡牌了！		
GAMEPLAY_EMOTE_HERO_08B_OOPS	呃……一个小失误。		
GAMEPLAY_EMOTE_HERO_08B_SORRY	真是抱歉。		
GAMEPLAY_EMOTE_HERO_08B_START	知识就是力量。		
GAMEPLAY_EMOTE_HERO_08B_THANKS	谢谢你，朋友。		
GAMEPLAY_EMOTE_HERO_08B_THINK1	嗯……		
GAMEPLAY_EMOTE_HERO_08B_THINK2	观察，并思考……		
GAMEPLAY_EMOTE_HERO_08B_THINK3	一定有什么办法……		
GAMEPLAY_EMOTE_HERO_08B_THREATEN	如此傲慢无礼，是该给你点教训了！		
GAMEPLAY_EMOTE_HERO_08B_TIMER	注意时间！		
GAMEPLAY_EMOTE_HERO_08B_WELL_PLAYED	打得不错。		
GAMEPLAY_EMOTE_HERO_08B_WINTERVEIL_GREETINGS	冬幕节快乐！		
GAMEPLAY_EMOTE_HERO_08B_WOW	精彩绝伦。		
GAMEPLAY_EMOTE_HERO_09_CONCEDE	你击败了我。		
GAMEPLAY_EMOTE_HERO_09_ERROR_FULL_MINIONS	我无法再拥有更多随从了。		
GAMEPLAY_EMOTE_HERO_09_ERROR_GENERIC	我无法\n这么做。		
GAMEPLAY_EMOTE_HERO_09_ERROR_HAND_FULL	我的手牌\n已经满了！		
GAMEPLAY_EMOTE_HERO_09_ERROR_I_ATTACKED	我已经进行过攻击了！		
GAMEPLAY_EMOTE_HERO_09_ERROR_JUST_PLAYED	那个随从需要一个回合\n进行准备。		
GAMEPLAY_EMOTE_HERO_09_ERROR_MINION_ATTACKED	那个随从已经进行过攻击了。		
GAMEPLAY_EMOTE_HERO_09_ERROR_NEED_MANA	我没有足够的法力值。		
GAMEPLAY_EMOTE_HERO_09_ERROR_NEED_WEAPON	我需要\n一把武器。		
GAMEPLAY_EMOTE_HERO_09_ERROR_PLAY	我无法\n使用它。		
GAMEPLAY_EMOTE_HERO_09_ERROR_STEALTH	我无法将具有潜行技能的随从作为目标。		
GAMEPLAY_EMOTE_HERO_09_ERROR_TARGET	这不是一个\n有效的目标。		
GAMEPLAY_EMOTE_HERO_09_ERROR_TAUNT	我必须攻击\n那个具有嘲讽技能的随从。		
GAMEPLAY_EMOTE_HERO_09_EVENT_LUNAR_NEW_YEAR	新年好。		
GAMEPLAY_EMOTE_HERO_09_GOOD_GAME	精彩的比赛。		
GAMEPLAY_EMOTE_HERO_09_GREETINGS	你好。		
GAMEPLAY_EMOTE_HERO_09_LOW_CARDS	我的卡牌就快要用光了！		
GAMEPLAY_EMOTE_HERO_09_MIRROR_START	圣光也向我露出了微笑！		
GAMEPLAY_EMOTE_HERO_09_NO_CARDS	我已经没有\n卡牌了！		
GAMEPLAY_EMOTE_HERO_09_OOPS	和我的计划\n有些出入。		
GAMEPLAY_EMOTE_HERO_09_SORRY	抱歉。		
GAMEPLAY_EMOTE_HERO_09_START	圣光将赐予我胜利！		
GAMEPLAY_EMOTE_HERO_09_THANKS	谢谢你。		
GAMEPLAY_EMOTE_HERO_09_THINK1	嗯...		
GAMEPLAY_EMOTE_HERO_09_THINK2	我想….		
GAMEPLAY_EMOTE_HERO_09_THINK3	我要想一想…		
GAMEPLAY_EMOTE_HERO_09_THREATEN	圣光会\n制裁你！		
GAMEPLAY_EMOTE_HERO_09_TIMER	我要尽快\n做出选择…		
GAMEPLAY_EMOTE_HERO_09_WELL_PLAYED	打得不错。		
GAMEPLAY_EMOTE_HERO_09_WINTERVEIL_GREETINGS	冬幕节快乐！		
GAMEPLAY_EMOTE_HERO_09_WOW	哇喔....		
GAMEPLAY_EMOTE_HERO_TBKTRAF_KT_CONCEDE	我……会……回来的……		
GAMEPLAY_EMOTE_HERO_TBKTRAF_KT_GREETINGS	我们终于见面了！		
GAMEPLAY_EMOTE_HERO_TBKTRAF_KT_LOW_CARDS	我就快没牌了！		
GAMEPLAY_EMOTE_HERO_TBKTRAF_KT_NO_CARDS	不！！！诅咒你，入侵者，诅咒你！		
GAMEPLAY_EMOTE_HERO_TBKTRAF_KT_OOPS	哎，还得重新设计		
GAMEPLAY_EMOTE_HERO_TBKTRAF_KT_SORRY	不！诅咒你入侵者！诅咒你！		
GAMEPLAY_EMOTE_HERO_TBKTRAF_KT_START	我会亲自找你们算账的，入侵者！		
GAMEPLAY_EMOTE_HERO_TBKTRAF_KT_THANKS	我只是……尽地主之谊。		
GAMEPLAY_EMOTE_HERO_TBKTRAF_KT_THINK1	也许吧。		
GAMEPLAY_EMOTE_HERO_TBKTRAF_KT_THINK2	对……就是这样！		
GAMEPLAY_EMOTE_HERO_TBKTRAF_KT_THINK3	比格沃斯，你怎么看？		
GAMEPLAY_EMOTE_HERO_TBKTRAF_KT_THREATEN	我会冻结你的血液！		
GAMEPLAY_EMOTE_HERO_TBKTRAF_KT_WELL_PLAYED	哼，我当然打得不错，我可是克尔苏加德！		
GAMEPLAY_EMOTE_HERO_TBKTRAF_RAF_CONCEDE	不！我是不可战胜的……		
GAMEPLAY_EMOTE_HERO_TBKTRAF_RAF_GREETINGS	你好，探险者。		
GAMEPLAY_EMOTE_HERO_TBKTRAF_RAF_LOW_CARDS	我就快没牌了！		
GAMEPLAY_EMOTE_HERO_TBKTRAF_RAF_NO_CARDS	真怀念我的宝藏！		
GAMEPLAY_EMOTE_HERO_TBKTRAF_RAF_OOPS	我手滑了！		
GAMEPLAY_EMOTE_HERO_TBKTRAF_RAF_SORRY	我很同情你。		
GAMEPLAY_EMOTE_HERO_TBKTRAF_RAF_START	拉法姆才是最最伟大的考古学家！		
GAMEPLAY_EMOTE_HERO_TBKTRAF_RAF_THANKS	呃，谢谢你。		
GAMEPLAY_EMOTE_HERO_TBKTRAF_RAF_THINK1	嗯...		
GAMEPLAY_EMOTE_HERO_TBKTRAF_RAF_THINK2	拿哪张好呢……		
GAMEPLAY_EMOTE_HERO_TBKTRAF_RAF_THINK3	每张都想要……		
GAMEPLAY_EMOTE_HERO_TBKTRAF_RAF_THREATEN	如此强大的力量！		
GAMEPLAY_EMOTE_HERO_TBKTRAF_RAF_WELL_PLAYED	干得好……		
GAMEPLAY_EMOTE_HERO_TBMECHWAR01_CONCEDE	<战败>	The text is in brackets because the VO files is just Annoy-o-Tron's greeting	
GAMEPLAY_EMOTE_HERO_TBMECHWAR01_ERROR_FULL_MINIONS	<错误！>	The text is in brackets because the VO files is just Annoy-o-Tron's greeting	
GAMEPLAY_EMOTE_HERO_TBMECHWAR01_ERROR_HAND_FULL	<错误！>	The text is in brackets because the VO files is just Annoy-o-Tron's greeting	
GAMEPLAY_EMOTE_HERO_TBMECHWAR01_ERROR_I_ATTACKED	<错误！>	The text is in brackets because the VO files is just Annoy-o-Tron's greeting	
GAMEPLAY_EMOTE_HERO_TBMECHWAR01_ERROR_JUST_PLAYED	<错误！>	The text is in brackets because the VO files is just Annoy-o-Tron's greeting	
GAMEPLAY_EMOTE_HERO_TBMECHWAR01_ERROR_MINION_ATTACKED	<错误！>	The text is in brackets because the VO files is just Annoy-o-Tron's greeting	
GAMEPLAY_EMOTE_HERO_TBMECHWAR01_ERROR_NEED_MANA	<错误！>	The text is in brackets because the VO files is just Annoy-o-Tron's greeting	
GAMEPLAY_EMOTE_HERO_TBMECHWAR01_ERROR_NEED_WEAPON	<错误！>	The text is in brackets because the VO files is just Annoy-o-Tron's greeting	
GAMEPLAY_EMOTE_HERO_TBMECHWAR01_ERROR_PLAY	<错误！>	The text is in brackets because the VO files is just Annoy-o-Tron's greeting	
GAMEPLAY_EMOTE_HERO_TBMECHWAR01_ERROR_STEALTH	<错误！>	The text is in brackets because the VO files is just Annoy-o-Tron's greeting	
GAMEPLAY_EMOTE_HERO_TBMECHWAR01_ERROR_TARGET	<错误！>	The text is in brackets because the VO files is just Annoy-o-Tron's greeting	
GAMEPLAY_EMOTE_HERO_TBMECHWAR01_ERROR_TAUNT	<错误！>	The text is in brackets because the VO files is just Annoy-o-Tron's greeting	
GAMEPLAY_EMOTE_HERO_TBMECHWAR01_GREETINGS	<你好>	The text is in brackets because the VO files is just Annoy-o-Tron's greeting	
GAMEPLAY_EMOTE_HERO_TBMECHWAR01_LOW_CARDS	<卡牌不足>	The text is in brackets because the VO files is just Annoy-o-Tron's greeting	
GAMEPLAY_EMOTE_HERO_TBMECHWAR01_NO_CARDS	<没有卡牌>	The text is in brackets because the VO files is just Annoy-o-Tron's greeting	
GAMEPLAY_EMOTE_HERO_TBMECHWAR01_OOPS	<错误>	The text is in brackets because the VO files is just Annoy-o-Tron's greeting	
GAMEPLAY_EMOTE_HERO_TBMECHWAR01_SORRY	<抱歉>	The text is in brackets because the VO files is just Annoy-o-Tron's greeting	
GAMEPLAY_EMOTE_HERO_TBMECHWAR01_START	<开始>	The text is in brackets because the VO files is just Annoy-o-Tron's greeting	
GAMEPLAY_EMOTE_HERO_TBMECHWAR01_THANKS	<谢谢>	The text is in brackets because the VO files is just Annoy-o-Tron's greeting	
GAMEPLAY_EMOTE_HERO_TBMECHWAR01_THINK1	<处理中…>	The text is in brackets because the VO files is just Annoy-o-Tron's greeting	
GAMEPLAY_EMOTE_HERO_TBMECHWAR01_THINK2	<获取目标…>	The text is in brackets because the VO files is just Annoy-o-Tron's greeting	
GAMEPLAY_EMOTE_HERO_TBMECHWAR01_THINK3	<耗费周期…>	The text is in brackets because the VO files is just Annoy-o-Tron's greeting	
GAMEPLAY_EMOTE_HERO_TBMECHWAR01_THREATEN	<威胁>	The text is in brackets because the VO files is just Annoy-o-Tron's attack	
GAMEPLAY_EMOTE_HERO_TBMECHWAR01_TIMER	<时日无多>	The text is in brackets because the VO files is just Annoy-o-Tron's greeting	
GAMEPLAY_EMOTE_HERO_TBMECHWAR01_WELL_PLAYED	<打得不错>	The text is in brackets because the VO files is just Annoy-o-Tron's greeting	
GAMEPLAY_EMOTE_HERO_TBMECHWAR02_CONCEDE	<阵列结束>	The text is in brackets because the VO files is just Boom Bot's greeting	
GAMEPLAY_EMOTE_HERO_TBMECHWAR02_ERROR_FULL_MINIONS	<错误！>	The text is in brackets because the VO files is just Boom Bot's greeting	
GAMEPLAY_EMOTE_HERO_TBMECHWAR02_ERROR_HAND_FULL	<错误！>	The text is in brackets because the VO files is just Boom Bot's greeting	
GAMEPLAY_EMOTE_HERO_TBMECHWAR02_ERROR_I_ATTACKED	<错误！>	The text is in brackets because the VO files is just Boom Bot's greeting	
GAMEPLAY_EMOTE_HERO_TBMECHWAR02_ERROR_JUST_PLAYED	<错误！>	The text is in brackets because the VO files is just Boom Bot's greeting	
GAMEPLAY_EMOTE_HERO_TBMECHWAR02_ERROR_MINION_ATTACKED	<错误！>	The text is in brackets because the VO files is just Boom Bot's greeting	
GAMEPLAY_EMOTE_HERO_TBMECHWAR02_ERROR_NEED_MANA	<错误！>	The text is in brackets because the VO files is just Boom Bot's greeting	
GAMEPLAY_EMOTE_HERO_TBMECHWAR02_ERROR_NEED_WEAPON	<错误！>	The text is in brackets because the VO files is just Boom Bot's greeting	
GAMEPLAY_EMOTE_HERO_TBMECHWAR02_ERROR_PLAY	<错误！>	The text is in brackets because the VO files is just Boom Bot's greeting	
GAMEPLAY_EMOTE_HERO_TBMECHWAR02_ERROR_STEALTH	<错误！>	The text is in brackets because the VO files is just Boom Bot's greeting	
GAMEPLAY_EMOTE_HERO_TBMECHWAR02_ERROR_TARGET	<错误！>	The text is in brackets because the VO files is just Boom Bot's greeting	
GAMEPLAY_EMOTE_HERO_TBMECHWAR02_ERROR_TAUNT	<错误！>	The text is in brackets because the VO files is just Boom Bot's greeting	
GAMEPLAY_EMOTE_HERO_TBMECHWAR02_GREETINGS	<你好>	The text is in brackets because the VO files is just Annoy-o-Tron's greeting	
GAMEPLAY_EMOTE_HERO_TBMECHWAR02_LOW_CARDS	<卡牌不足>	The text is in brackets because the VO files is just Boom Bot's greeting	
GAMEPLAY_EMOTE_HERO_TBMECHWAR02_NO_CARDS	<没有卡牌>	The text is in brackets because the VO files is just Boom Bot's greeting	
GAMEPLAY_EMOTE_HERO_TBMECHWAR02_OOPS	<错误！>	The text is in brackets because the VO files is just Boom Bot's greeting	
GAMEPLAY_EMOTE_HERO_TBMECHWAR02_SORRY	<抱歉>	The text is in brackets because the VO files is just Boom Bot's greeting	
GAMEPLAY_EMOTE_HERO_TBMECHWAR02_START	<初始化>	The text is in brackets because the VO files is just Boom Bot's greeting	
GAMEPLAY_EMOTE_HERO_TBMECHWAR02_THANKS	<谢谢>	The text is in brackets because the VO files is just Boom Bot's greeting	
GAMEPLAY_EMOTE_HERO_TBMECHWAR02_THINK1	<处理中…>	The text is in brackets because the VO files is just Boom Bot's greeting	
GAMEPLAY_EMOTE_HERO_TBMECHWAR02_THINK2	<获取目标…>	The text is in brackets because the VO files is just Boom Bot's greeting	
GAMEPLAY_EMOTE_HERO_TBMECHWAR02_THINK3	<耗费周期…>	The text is in brackets because the VO files is just Boom Bot's greeting	
GAMEPLAY_EMOTE_HERO_TBMECHWAR02_THREATEN	<威胁>	The text is in brackets because the VO files is just Boom Bot's Attack sound	
GAMEPLAY_EMOTE_HERO_TBMECHWAR02_TIMER	<时日无多>	The text is in brackets because the VO files is just Boom Bot's greeting	
GAMEPLAY_EMOTE_HERO_TBMECHWAR02_WELL_PLAYED	<打得不错>	The text is in brackets because the VO files is just Boom Bot's greeting	
VO_BRM_027h__LUNAR_NEW_YEAR	在火焰中迎来新的一年！		
VO_BRM_027h_Attack_15	尝尝萨弗隆的火焰吧！		
VO_BRM_027h_Concede_11	你赢了，很精彩！		
VO_BRM_027h_Emote_Start	我会复仇的，黑龙！		
VO_BRM_027h_ERROR01_51	我需要一把武器。		
VO_BRM_027h_ERROR02_52	法力值不足。		
VO_BRM_027h_ERROR03_53	他已经攻击过了。		
VO_BRM_027h_ERROR04_54	我已经进行过攻击了。		
VO_BRM_027h_ERROR05_55	凡人们需要一个回合进行准备。		
VO_BRM_027h_ERROR06_56	手牌太多了。		
VO_BRM_027h_ERROR07_57	随从太多了。		
VO_BRM_027h_ERROR08_58	它正在潜行，我无法攻击。		
VO_BRM_027h_ERROR09_59	不能使用。		
VO_BRM_027h_ERROR10_60	不行。		
VO_BRM_027h_ERROR11_61	那个嘲讽的随从挡住我了。		
VO_BRM_027h_ERROR12_62	不能这么做。		
VO_BRM_027h_GG_16	精彩的对决！		
VO_BRM_027h_Greetings_04	让火焰净化一切！		
VO_BRM_027h_HAPPY_NEW_YEAR_38	在火焰中迎来新的一年！		
VO_BRM_027h_LowCards_49	我快把我的牌都烧光了！		
VO_BRM_027h_NoCards_50	我的牌都被烧光了！		
VO_BRM_027h_Oops_07	啊！犯了个错误！		
VO_BRM_027h_Sorry_10	抱歉。		
VO_BRM_027h_Thanks_09	热忱的感谢。		
VO_BRM_027h_Thinking1_12	嗯…		
VO_BRM_027h_Thinking2_13	我想…		
VO_BRM_027h_Thinking3_14	先把什么烧焦呢…		
VO_BRM_027h_Threaten_08	你将在烈焰中灰飞烟灭！		
VO_BRM_027h_Time_48	时间都被烧光了！		
VO_BRM_027h_Well_Played_06	打得不错。		
VO_BRM_027h_Winterveil_Greetings	冬幕节应该\n再暖和一些！		
VO_BRM_027h_WOW_20	棒极了。		
VO_TBA01_4__Concede	*低吼*		
VO_TBA01_4__Error_Full_Minions	*低吼*		
VO_TBA01_4__Error_Generic	*低吼*		
VO_TBA01_4__Error_Hand_Full	*低吼*		
VO_TBA01_4__Error_I_Attacked	*低吼*		
VO_TBA01_4__Error_Just_Played	*低吼*		
VO_TBA01_4__Error_Minion_Attacked	*低吼*		
VO_TBA01_4__Error_Need_Mana	*低吼*		
VO_TBA01_4__Error_Need_Weapon	*低吼*		
VO_TBA01_4__Error_Play	*低吼*		
VO_TBA01_4__Error_Stealth	*低吼*		
VO_TBA01_4__Good_Game	*低吼*		
VO_TBA01_4__Greetings	游戏开始了！		
VO_TBA01_4__Low_Cards	*低吼*		
VO_TBA01_4__No_Cards	*低吼*		
VO_TBA01_4__Oops	喔，糟了。		
VO_TBA01_4__Sorry	抱歉。		
VO_TBA01_4__Start	我才是这里的主人！		
VO_TBA01_4__Thanks	谢谢。		
VO_TBA01_4__Threaten	哈哈哈！看好了，黑龙王子真正的力量！		
VO_TBA01_4__Timer	*低吼*		
VO_TBA01_4__Well_Played	打的不错。		
